,zone,time_window,weekday_pickup,weekend_pickup,weekday_dropoff,weekend_dropoff,weekday_differentials,weekend_differentials,supply_surplus_weekday,supply_surplus_weekend
0,1,1,1,0,8,1,7,1,True,True
1,1,2,3,0,13,6,10,6,True,True
2,1,3,0,0,13,2,13,2,True,True
3,1,4,1,0,12,3,11,3,True,True
4,1,5,1,0,9,5,8,5,True,True
5,1,6,1,0,12,9,11,9,True,True
6,1,7,2,0,23,8,21,8,True,True
7,1,8,5,2,58,24,53,22,True,True
8,1,9,6,5,108,55,102,50,True,True
9,1,10,20,6,259,88,239,82,True,True
10,1,11,15,7,399,139,384,132,True,True
11,1,12,18,13,574,181,556,168,True,True
12,1,13,22,7,529,186,507,179,True,True
13,1,14,16,9,471,202,455,193,True,True
14,1,15,21,14,429,225,408,211,True,True
15,1,16,15,4,302,168,287,164,True,True
16,1,17,8,4,284,171,276,167,True,True
17,1,18,22,4,313,177,291,173,True,True
18,1,19,9,7,305,173,296,166,True,True
19,1,20,7,9,333,175,326,166,True,True
20,1,21,15,11,335,156,320,145,True,True
21,1,22,8,14,382,192,374,178,True,True
22,1,23,16,8,339,169,323,161,True,True
23,1,24,15,7,401,189,386,182,True,True
24,1,25,17,4,346,157,329,153,True,True
25,1,26,17,5,426,203,409,198,True,True
26,1,27,17,6,399,162,382,156,True,True
27,1,28,20,12,518,212,498,200,True,True
28,1,29,21,13,530,248,509,235,True,True
29,1,30,20,18,587,324,567,306,True,True
30,1,31,42,25,692,363,650,338,True,True
31,1,32,36,16,715,400,679,384,True,True
32,1,33,22,7,625,354,603,347,True,True
33,1,34,22,18,434,327,412,309,True,True
34,1,35,23,16,363,249,340,233,True,True
35,1,36,12,7,286,201,274,194,True,True
36,1,37,11,4,287,186,276,182,True,True
37,1,38,12,18,291,208,279,190,True,True
38,1,39,12,11,297,148,285,137,True,True
39,1,40,17,7,236,123,219,116,True,True
40,1,41,11,4,144,62,133,58,True,True
41,1,42,7,4,108,51,101,47,True,True
42,1,43,5,3,75,30,70,27,True,True
43,1,44,1,0,46,13,45,13,True,True
44,1,45,1,0,23,9,22,9,True,True
45,1,46,1,1,17,7,16,6,True,True
46,1,47,2,0,18,6,16,6,True,True
47,1,48,1,0,14,4,13,4,True,True
48,2,1,1,0,2,0,1,0,True,False
49,2,2,0,0,0,0,0,0,False,False
50,2,3,0,0,0,0,0,0,False,False
51,2,4,0,0,0,0,0,0,False,False
52,2,5,0,0,0,0,0,0,False,False
53,2,6,0,0,0,0,0,0,False,False
54,2,7,0,0,0,0,0,0,False,False
55,2,8,0,0,0,0,0,0,False,False
56,2,9,0,0,0,0,0,0,False,False
57,2,10,0,0,0,0,0,0,False,False
58,2,11,0,0,0,0,0,0,False,False
59,2,12,0,0,0,0,0,0,False,False
60,2,13,0,0,1,0,1,0,True,False
61,2,14,0,0,0,0,0,0,False,False
62,2,15,0,0,0,0,0,0,False,False
63,2,16,0,0,0,0,0,0,False,False
64,2,17,0,0,0,1,0,1,False,True
65,2,18,0,0,0,0,0,0,False,False
66,2,19,0,0,0,0,0,0,False,False
67,2,20,0,0,0,0,0,0,False,False
68,2,21,0,0,0,0,0,0,False,False
69,2,22,0,0,0,0,0,0,False,False
70,2,23,1,1,1,0,0,-1,False,False
71,2,24,0,0,0,0,0,0,False,False
72,2,25,0,0,0,0,0,0,False,False
73,2,26,0,0,0,0,0,0,False,False
74,2,27,0,0,0,0,0,0,False,False
75,2,28,0,0,0,0,0,0,False,False
76,2,29,0,0,1,0,1,0,True,False
77,2,30,0,0,0,0,0,0,False,False
78,2,31,0,0,0,0,0,0,False,False
79,2,32,0,0,0,0,0,0,False,False
80,2,33,0,0,2,0,2,0,True,False
81,2,34,0,0,0,0,0,0,False,False
82,2,35,0,0,0,1,0,1,False,True
83,2,36,0,0,0,0,0,0,False,False
84,2,37,0,0,0,0,0,0,False,False
85,2,38,0,0,0,0,0,0,False,False
86,2,39,0,0,0,0,0,0,False,False
87,2,40,0,0,0,0,0,0,False,False
88,2,41,0,0,0,0,0,0,False,False
89,2,42,0,1,0,0,0,-1,False,False
90,2,43,0,0,0,0,0,0,False,False
91,2,44,0,0,0,0,0,0,False,False
92,2,45,0,0,0,0,0,0,False,False
93,2,46,1,0,1,0,0,0,False,False
94,2,47,2,0,2,0,0,0,False,False
95,2,48,4,0,4,0,0,0,False,False
96,3,1,0,0,29,6,29,6,True,True
97,3,2,0,1,18,9,18,8,True,True
98,3,3,0,1,17,10,17,9,True,True
99,3,4,0,0,10,11,10,11,True,True
100,3,5,0,0,14,14,14,14,True,True
101,3,6,0,2,4,17,4,15,True,True
102,3,7,1,0,6,16,5,16,True,True
103,3,8,1,2,4,11,3,9,True,True
104,3,9,0,0,3,15,3,15,True,True
105,3,10,0,2,6,10,6,8,True,True
106,3,11,1,0,3,6,2,6,True,True
107,3,12,1,1,5,2,4,1,True,True
108,3,13,0,1,2,7,2,6,True,True
109,3,14,0,0,4,4,4,4,True,True
110,3,15,0,0,4,0,4,0,True,False
111,3,16,1,0,8,1,7,1,True,True
112,3,17,0,0,3,2,3,2,True,True
113,3,18,0,0,5,1,5,1,True,True
114,3,19,0,0,2,3,2,3,True,True
115,3,20,0,0,4,3,4,3,True,True
116,3,21,1,1,7,4,6,3,True,True
117,3,22,0,0,1,1,1,1,True,True
118,3,23,1,0,6,5,5,5,True,True
119,3,24,0,0,4,0,4,0,True,False
120,3,25,0,0,3,7,3,7,True,True
121,3,26,0,0,1,1,1,1,True,True
122,3,27,1,0,7,3,6,3,True,True
123,3,28,0,0,3,5,3,5,True,True
124,3,29,1,0,6,4,5,4,True,True
125,3,30,0,0,6,4,6,4,True,True
126,3,31,0,0,8,2,8,2,True,True
127,3,32,0,0,5,1,5,1,True,True
128,3,33,0,0,4,8,4,8,True,True
129,3,34,0,1,7,5,7,4,True,True
130,3,35,1,0,5,8,4,8,True,True
131,3,36,1,0,9,5,8,5,True,True
132,3,37,0,0,5,6,5,6,True,True
133,3,38,0,0,8,8,8,8,True,True
134,3,39,0,0,8,3,8,3,True,True
135,3,40,1,1,9,7,8,6,True,True
136,3,41,0,0,8,3,8,3,True,True
137,3,42,0,0,9,1,9,1,True,True
138,3,43,0,0,12,4,12,4,True,True
139,3,44,2,0,14,8,12,8,True,True
140,3,45,0,0,18,8,18,8,True,True
141,3,46,1,0,27,9,26,9,True,True
142,3,47,0,0,22,4,22,4,True,True
143,3,48,2,0,24,5,22,5,True,True
144,4,1,743,1075,1354,1168,611,93,True,True
145,4,2,690,1160,1250,1268,560,108,True,True
146,4,3,576,1180,1074,1070,498,-110,True,False
147,4,4,438,1191,750,1055,312,-136,True,False
148,4,5,358,1200,643,969,285,-231,True,False
149,4,6,274,1094,540,910,266,-184,True,False
150,4,7,245,890,439,784,194,-106,True,False
151,4,8,184,699,388,649,204,-50,True,False
152,4,9,194,555,345,606,151,51,True,True
153,4,10,154,296,245,409,91,113,True,True
154,4,11,201,196,182,317,-19,121,False,True
155,4,12,309,174,167,184,-142,10,False,True
156,4,13,432,177,169,169,-263,-8,False,False
157,4,14,558,162,220,113,-338,-49,False,False
158,4,15,603,179,330,115,-273,-64,False,False
159,4,16,709,216,491,123,-218,-93,False,False
160,4,17,836,254,514,138,-322,-116,False,False
161,4,18,743,316,324,157,-419,-159,False,False
162,4,19,701,358,323,195,-378,-163,False,False
163,4,20,699,384,371,236,-328,-148,False,False
164,4,21,692,418,454,273,-238,-145,False,False
165,4,22,608,437,445,296,-163,-141,False,False
166,4,23,479,459,506,370,27,-89,True,False
167,4,24,510,449,474,424,-36,-25,False,False
168,4,25,410,419,513,537,103,118,True,True
169,4,26,405,410,525,535,120,125,True,True
170,4,27,389,406,578,472,189,66,True,True
171,4,28,371,371,550,478,179,107,True,True
172,4,29,421,428,646,524,225,96,True,True
173,4,30,393,352,686,453,293,101,True,True
174,4,31,386,356,689,521,303,165,True,True
175,4,32,360,329,689,478,329,149,True,True
176,4,33,287,294,677,486,390,192,True,True
177,4,34,270,291,649,461,379,170,True,True
178,4,35,353,296,894,493,541,197,True,True
179,4,36,530,380,1137,603,607,223,True,True
180,4,37,630,360,1381,629,751,269,True,True
181,4,38,714,421,1584,706,870,285,True,True
182,4,39,771,430,1738,767,967,337,True,True
183,4,40,810,400,1971,756,1161,356,True,True
184,4,41,744,448,1937,822,1193,374,True,True
185,4,42,876,411,1968,777,1092,366,True,True
186,4,43,985,444,2041,834,1056,390,True,True
187,4,44,891,482,1946,856,1055,374,True,True
188,4,45,981,457,1872,878,891,421,True,True
189,4,46,1027,574,1896,975,869,401,True,True
190,4,47,1001,650,1785,1018,784,368,True,True
191,4,48,1065,640,1804,1020,739,380,True,True
192,5,1,0,0,2,0,2,0,True,False
193,5,2,2,0,3,2,1,2,True,True
194,5,3,0,0,3,2,3,2,True,True
195,5,4,0,0,1,2,1,2,True,True
196,5,5,0,0,2,1,2,1,True,True
197,5,6,0,0,1,0,1,0,True,False
198,5,7,0,0,2,1,2,1,True,True
199,5,8,0,0,0,1,0,1,False,True
200,5,9,0,0,1,1,1,1,True,True
201,5,10,0,0,1,0,1,0,True,False
202,5,11,0,0,1,1,1,1,True,True
203,5,12,0,0,0,0,0,0,False,False
204,5,13,0,0,0,1,0,1,False,True
205,5,14,0,0,0,1,0,1,False,True
206,5,15,0,0,1,0,1,0,True,False
207,5,16,0,0,0,0,0,0,False,False
208,5,17,0,0,0,0,0,0,False,False
209,5,18,0,0,0,0,0,0,False,False
210,5,19,0,0,0,1,0,1,False,True
211,5,20,0,0,0,1,0,1,False,True
212,5,21,0,0,0,1,0,1,False,True
213,5,22,0,0,0,0,0,0,False,False
214,5,23,0,0,1,0,1,0,True,False
215,5,24,0,0,1,0,1,0,True,False
216,5,25,0,0,0,0,0,0,False,False
217,5,26,0,0,0,0,0,0,False,False
218,5,27,0,0,0,0,0,0,False,False
219,5,28,0,0,1,0,1,0,True,False
220,5,29,0,0,1,0,1,0,True,False
221,5,30,0,0,0,0,0,0,False,False
222,5,31,0,0,1,0,1,0,True,False
223,5,32,0,0,0,1,0,1,False,True
224,5,33,0,0,0,1,0,1,False,True
225,5,34,0,0,0,0,0,0,False,False
226,5,35,0,0,1,0,1,0,True,False
227,5,36,0,0,0,1,0,1,False,True
228,5,37,0,0,0,1,0,1,False,True
229,5,38,0,0,0,0,0,0,False,False
230,5,39,0,0,0,0,0,0,False,False
231,5,40,0,0,0,0,0,0,False,False
232,5,41,0,0,2,0,2,0,True,False
233,5,42,0,0,2,0,2,0,True,False
234,5,43,0,0,1,0,1,0,True,False
235,5,44,0,0,6,1,6,1,True,True
236,5,45,0,0,1,0,1,0,True,False
237,5,46,0,0,3,0,3,0,True,False
238,5,47,0,0,3,0,3,0,True,False
239,5,48,0,0,1,1,1,1,True,True
240,6,1,2,1,9,0,7,-1,True,False
241,6,2,0,0,6,4,6,4,True,True
242,6,3,1,1,6,2,5,1,True,True
243,6,4,0,0,4,10,4,10,True,True
244,6,5,0,0,3,4,3,4,True,True
245,6,6,0,0,4,5,4,5,True,True
246,6,7,0,0,3,3,3,3,True,True
247,6,8,0,2,1,4,1,2,True,True
248,6,9,0,0,2,4,2,4,True,True
249,6,10,0,0,1,1,1,1,True,True
250,6,11,0,0,5,4,5,4,True,True
251,6,12,0,0,1,1,1,1,True,True
252,6,13,0,0,2,1,2,1,True,True
253,6,14,1,0,1,2,0,2,False,True
254,6,15,0,1,1,1,1,0,True,False
255,6,16,0,2,1,3,1,1,True,True
256,6,17,0,0,0,2,0,2,False,True
257,6,18,0,2,3,0,3,-2,True,False
258,6,19,0,1,8,3,8,2,True,True
259,6,20,0,1,2,2,2,1,True,True
260,6,21,0,0,2,0,2,0,True,False
261,6,22,1,0,0,0,-1,0,False,False
262,6,23,0,0,0,2,0,2,False,True
263,6,24,0,0,0,0,0,0,False,False
264,6,25,0,0,2,1,2,1,True,True
265,6,26,0,0,0,1,0,1,False,True
266,6,27,0,0,0,0,0,0,False,False
267,6,28,0,0,0,1,0,1,False,True
268,6,29,0,0,1,0,1,0,True,False
269,6,30,0,0,4,1,4,1,True,True
270,6,31,0,0,2,0,2,0,True,False
271,6,32,0,0,2,3,2,3,True,True
272,6,33,0,0,2,2,2,2,True,True
273,6,34,0,0,1,3,1,3,True,True
274,6,35,1,1,0,2,-1,1,False,True
275,6,36,2,0,3,1,1,1,True,True
276,6,37,0,0,2,3,2,3,True,True
277,6,38,3,0,4,2,1,2,True,True
278,6,39,1,0,4,0,3,0,True,False
279,6,40,0,0,4,1,4,1,True,True
280,6,41,1,1,9,1,8,0,True,False
281,6,42,0,0,12,2,12,2,True,True
282,6,43,0,0,15,5,15,5,True,True
283,6,44,0,0,15,3,15,3,True,True
284,6,45,1,0,12,3,11,3,True,True
285,6,46,0,0,8,1,8,1,True,True
286,6,47,1,0,15,2,14,2,True,True
287,6,48,1,0,7,6,6,6,True,True
288,7,1,778,637,2998,1460,2220,823,True,True
289,7,2,827,734,3116,1917,2289,1183,True,True
290,7,3,709,749,2666,2015,1957,1266,True,True
291,7,4,587,713,1906,1991,1319,1278,True,True
292,7,5,547,773,1707,1998,1160,1225,True,True
293,7,6,480,725,1284,1853,804,1128,True,True
294,7,7,430,663,1051,1667,621,1004,True,True
295,7,8,361,565,848,1504,487,939,True,True
296,7,9,424,681,870,1381,446,700,True,True
297,7,10,408,485,696,1151,288,666,True,True
298,7,11,480,388,449,800,-31,412,False,True
299,7,12,524,327,321,488,-203,161,False,True
300,7,13,589,250,286,331,-303,81,False,True
301,7,14,629,285,259,208,-370,-77,False,False
302,7,15,729,242,248,186,-481,-56,False,False
303,7,16,716,301,333,197,-383,-104,False,False
304,7,17,693,272,283,197,-410,-75,False,False
305,7,18,514,329,242,182,-272,-147,False,False
306,7,19,413,390,247,262,-166,-128,False,False
307,7,20,337,383,255,237,-82,-146,False,False
308,7,21,318,346,309,261,-9,-85,False,False
309,7,22,313,354,282,262,-31,-92,False,False
310,7,23,291,282,276,268,-15,-14,False,False
311,7,24,276,261,333,233,57,-28,True,False
312,7,25,260,232,297,288,37,56,True,True
313,7,26,238,234,334,301,96,67,True,True
314,7,27,213,239,337,287,124,48,True,True
315,7,28,236,229,370,267,134,38,True,True
316,7,29,251,232,377,263,126,31,True,True
317,7,30,226,196,410,315,184,119,True,True
318,7,31,213,228,429,290,216,62,True,True
319,7,32,191,181,399,315,208,134,True,True
320,7,33,189,190,346,341,157,151,True,True
321,7,34,226,218,376,294,150,76,True,True
322,7,35,285,252,459,347,174,95,True,True
323,7,36,297,218,567,384,270,166,True,True
324,7,37,325,211,656,415,331,204,True,True
325,7,38,297,196,768,392,471,196,True,True
326,7,39,301,219,773,482,472,263,True,True
327,7,40,307,237,959,438,652,201,True,True
328,7,41,281,254,996,472,715,218,True,True
329,7,42,309,222,1198,496,889,274,True,True
330,7,43,357,237,1369,578,1012,341,True,True
331,7,44,400,303,1703,636,1303,333,True,True
332,7,45,504,318,1980,742,1476,424,True,True
333,7,46,622,382,2476,863,1854,481,True,True
334,7,47,646,458,2783,1027,2137,569,True,True
335,7,48,719,483,2993,1266,2274,783,True,True
336,8,1,0,1,10,5,10,4,True,True
337,8,2,2,4,11,9,9,5,True,True
338,8,3,2,0,10,10,8,10,True,True
339,8,4,1,0,10,14,9,14,True,True
340,8,5,0,1,7,12,7,11,True,True
341,8,6,3,0,7,9,4,9,True,True
342,8,7,0,1,8,12,8,11,True,True
343,8,8,2,0,3,10,1,10,True,True
344,8,9,0,0,3,5,3,5,True,True
345,8,10,4,1,0,5,-4,4,False,True
346,8,11,1,0,2,4,1,4,True,True
347,8,12,6,1,2,2,-4,1,False,True
348,8,13,6,1,0,2,-6,1,False,True
349,8,14,7,2,0,0,-7,-2,False,False
350,8,15,4,2,2,0,-2,-2,False,False
351,8,16,14,6,2,4,-12,-2,False,False
352,8,17,7,2,3,2,-4,0,False,False
353,8,18,7,2,1,1,-6,-1,False,False
354,8,19,15,2,3,3,-12,1,False,True
355,8,20,9,7,1,2,-8,-5,False,False
356,8,21,10,5,2,4,-8,-1,False,False
357,8,22,3,3,0,1,-3,-2,False,False
358,8,23,2,2,3,4,1,2,True,True
359,8,24,4,4,0,6,-4,2,False,True
360,8,25,2,1,2,1,0,0,False,False
361,8,26,4,4,1,4,-3,0,False,False
362,8,27,1,3,0,2,-1,-1,False,False
363,8,28,2,1,2,2,0,1,False,True
364,8,29,5,1,2,5,-3,4,False,True
365,8,30,2,3,4,3,2,0,True,False
366,8,31,2,0,2,7,0,7,False,True
367,8,32,2,4,0,2,-2,-2,False,False
368,8,33,3,7,2,6,-1,-1,False,False
369,8,34,4,4,5,5,1,1,True,True
370,8,35,1,4,1,8,0,4,False,True
371,8,36,3,4,5,5,2,1,True,True
372,8,37,0,4,16,2,16,-2,True,False
373,8,38,3,3,8,2,5,-1,True,False
374,8,39,1,1,10,1,9,0,True,False
375,8,40,4,1,14,4,10,3,True,True
376,8,41,4,7,14,1,10,-6,True,False
377,8,42,3,1,19,8,16,7,True,True
378,8,43,2,1,14,4,12,3,True,True
379,8,44,3,1,10,2,7,1,True,True
380,8,45,1,3,8,1,7,-2,True,False
381,8,46,8,2,14,4,6,2,True,True
382,8,47,4,1,12,3,8,2,True,True
383,8,48,3,1,16,7,13,6,True,True
384,9,1,1,0,16,4,15,4,True,True
385,9,2,1,0,29,13,28,13,True,True
386,9,3,1,1,12,16,11,15,True,True
387,9,4,0,1,25,17,25,16,True,True
388,9,5,0,1,13,10,13,9,True,True
389,9,6,0,0,4,16,4,16,True,True
390,9,7,0,1,7,15,7,14,True,True
391,9,8,0,0,4,15,4,15,True,True
392,9,9,1,0,4,15,3,15,True,True
393,9,10,2,0,4,8,2,8,True,True
394,9,11,0,0,2,7,2,7,True,True
395,9,12,0,2,5,5,5,3,True,True
396,9,13,0,1,2,4,2,3,True,True
397,9,14,0,0,1,0,1,0,True,False
398,9,15,1,0,3,1,2,1,True,True
399,9,16,1,0,5,3,4,3,True,True
400,9,17,0,0,4,3,4,3,True,True
401,9,18,0,0,9,5,9,5,True,True
402,9,19,1,0,3,6,2,6,True,True
403,9,20,2,0,7,5,5,5,True,True
404,9,21,0,0,5,6,5,6,True,True
405,9,22,0,1,4,3,4,2,True,True
406,9,23,1,0,2,1,1,1,True,True
407,9,24,1,0,4,4,3,4,True,True
408,9,25,1,0,7,6,6,6,True,True
409,9,26,0,0,3,3,3,3,True,True
410,9,27,0,0,6,3,6,3,True,True
411,9,28,1,1,4,4,3,3,True,True
412,9,29,0,0,11,1,11,1,True,True
413,9,30,0,0,8,4,8,4,True,True
414,9,31,0,0,11,3,11,3,True,True
415,9,32,0,0,11,1,11,1,True,True
416,9,33,0,1,15,4,15,3,True,True
417,9,34,1,0,13,4,12,4,True,True
418,9,35,0,0,11,3,11,3,True,True
419,9,36,0,0,13,6,13,6,True,True
420,9,37,0,2,6,7,6,5,True,True
421,9,38,0,0,5,2,5,2,True,True
422,9,39,0,0,13,4,13,4,True,True
423,9,40,0,0,20,4,20,4,True,True
424,9,41,0,0,12,7,12,7,True,True
425,9,42,0,0,16,8,16,8,True,True
426,9,43,0,0,25,8,25,8,True,True
427,9,44,0,0,21,3,21,3,True,True
428,9,45,0,0,29,3,29,3,True,True
429,9,46,0,0,23,3,23,3,True,True
430,9,47,1,0,22,4,21,4,True,True
431,9,48,0,0,27,7,27,7,True,True
432,10,1,22,12,103,63,81,51,True,True
433,10,2,20,4,78,42,58,38,True,True
434,10,3,19,6,73,27,54,21,True,True
435,10,4,14,4,56,20,42,16,True,True
436,10,5,4,3,27,24,23,21,True,True
437,10,6,3,1,25,18,22,17,True,True
438,10,7,1,0,15,10,14,10,True,True
439,10,8,1,2,12,17,11,15,True,True
440,10,9,0,2,10,11,10,9,True,True
441,10,10,5,1,13,7,8,6,True,True
442,10,11,6,3,6,6,0,3,False,True
443,10,12,10,3,17,6,7,3,True,True
444,10,13,12,16,15,8,3,-8,True,False
445,10,14,25,19,12,9,-13,-10,False,False
446,10,15,31,4,18,14,-13,10,False,True
447,10,16,50,4,20,14,-30,10,False,True
448,10,17,58,18,37,9,-21,-9,False,False
449,10,18,35,12,20,11,-15,-1,False,False
450,10,19,18,5,20,10,2,5,True,True
451,10,20,20,6,12,11,-8,5,False,True
452,10,21,17,3,19,17,2,14,True,True
453,10,22,15,3,16,12,1,9,True,True
454,10,23,20,10,20,5,0,-5,False,False
455,10,24,35,9,24,12,-11,3,False,True
456,10,25,33,12,35,10,2,-2,True,False
457,10,26,30,13,36,20,6,7,True,True
458,10,27,41,19,33,12,-8,-7,False,False
459,10,28,49,21,33,17,-16,-4,False,False
460,10,29,53,14,28,12,-25,-2,False,False
461,10,30,55,25,44,22,-11,-3,False,False
462,10,31,67,32,49,23,-18,-9,False,False
463,10,32,67,33,33,24,-34,-9,False,False
464,10,33,61,39,55,27,-6,-12,False,False
465,10,34,63,29,49,23,-14,-6,False,False
466,10,35,80,40,51,28,-29,-12,False,False
467,10,36,72,43,63,29,-9,-14,False,False
468,10,37,65,37,57,34,-8,-3,False,False
469,10,38,55,31,71,30,16,-1,True,False
470,10,39,38,28,87,33,49,5,True,True
471,10,40,39,37,102,44,63,7,True,True
472,10,41,28,23,107,36,79,13,True,True
473,10,42,29,19,82,44,53,25,True,True
474,10,43,23,11,102,33,79,22,True,True
475,10,44,19,17,97,35,78,18,True,True
476,10,45,28,14,119,48,91,34,True,True
477,10,46,31,18,119,41,88,23,True,True
478,10,47,29,13,117,41,88,28,True,True
479,10,48,24,11,111,51,87,40,True,True
480,11,1,2,1,35,13,33,12,True,True
481,11,2,1,1,24,21,23,20,True,True
482,11,3,1,0,20,21,19,21,True,True
483,11,4,0,1,20,27,20,26,True,True
484,11,5,2,2,11,21,9,19,True,True
485,11,6,0,0,12,28,12,28,True,True
486,11,7,2,1,11,21,9,20,True,True
487,11,8,1,0,2,22,1,22,True,True
488,11,9,1,1,4,29,3,28,True,True
489,11,10,0,1,8,13,8,12,True,True
490,11,11,1,1,2,10,1,9,True,True
491,11,12,3,1,5,11,2,10,True,True
492,11,13,3,1,6,4,3,3,True,True
493,11,14,1,0,4,3,3,3,True,True
494,11,15,2,0,8,0,6,0,True,False
495,11,16,0,0,12,1,12,1,True,True
496,11,17,0,0,11,2,11,2,True,True
497,11,18,3,0,3,1,0,1,False,True
498,11,19,1,1,5,6,4,5,True,True
499,11,20,0,2,3,3,3,1,True,True
500,11,21,0,1,6,3,6,2,True,True
501,11,22,1,0,6,1,5,1,True,True
502,11,23,1,0,2,4,1,4,True,True
503,11,24,0,0,6,2,6,2,True,True
504,11,25,0,0,4,7,4,7,True,True
505,11,26,0,0,3,6,3,6,True,True
506,11,27,0,1,12,4,12,3,True,True
507,11,28,2,1,6,6,4,5,True,True
508,11,29,0,0,4,3,4,3,True,True
509,11,30,0,0,3,8,3,8,True,True
510,11,31,0,0,9,7,9,7,True,True
511,11,32,0,0,2,1,2,1,True,True
512,11,33,1,2,6,6,5,4,True,True
513,11,34,7,1,8,5,1,4,True,True
514,11,35,4,0,6,4,2,4,True,True
515,11,36,0,0,8,1,8,1,True,True
516,11,37,1,0,10,6,9,6,True,True
517,11,38,4,0,13,3,9,3,True,True
518,11,39,2,0,15,7,13,7,True,True
519,11,40,1,0,15,12,14,12,True,True
520,11,41,1,0,20,5,19,5,True,True
521,11,42,1,0,26,2,25,2,True,True
522,11,43,0,1,27,4,27,3,True,True
523,11,44,0,1,40,7,40,6,True,True
524,11,45,2,2,37,7,35,5,True,True
525,11,46,2,0,42,9,40,9,True,True
526,11,47,1,0,39,8,38,8,True,True
527,11,48,0,1,30,15,30,14,True,True
528,12,1,37,41,70,59,33,18,True,True
529,12,2,42,29,64,41,22,12,True,True
530,12,3,12,22,67,80,55,58,True,True
531,12,4,7,24,24,59,17,35,True,True
532,12,5,11,10,43,72,32,62,True,True
533,12,6,4,10,12,40,8,30,True,True
534,12,7,7,5,29,73,22,68,True,True
535,12,8,1,9,11,24,10,15,True,True
536,12,9,4,5,14,42,10,37,True,True
537,12,10,2,9,3,16,1,7,True,True
538,12,11,3,1,12,29,9,28,True,True
539,12,12,6,5,20,11,14,6,True,True
540,12,13,12,7,29,20,17,13,True,True
541,12,14,20,10,38,24,18,14,True,True
542,12,15,30,8,96,38,66,30,True,True
543,12,16,59,15,176,29,117,14,True,True
544,12,17,63,10,225,39,162,29,True,True
545,12,18,86,8,289,54,203,46,True,True
546,12,19,97,10,326,106,229,96,True,True
547,12,20,109,20,385,168,276,148,True,True
548,12,21,83,33,262,195,179,162,True,True
549,12,22,89,39,267,180,178,141,True,True
550,12,23,83,58,210,176,127,118,True,True
551,12,24,87,50,170,178,83,128,True,True
552,12,25,101,50,155,130,54,80,True,True
553,12,26,132,54,156,104,24,50,True,True
554,12,27,107,82,159,125,52,43,True,True
555,12,28,110,79,162,126,52,47,True,True
556,12,29,110,77,181,147,71,70,True,True
557,12,30,116,95,172,142,56,47,True,True
558,12,31,108,97,147,122,39,25,True,True
559,12,32,97,80,162,115,65,35,True,True
560,12,33,109,76,100,112,-9,36,False,True
561,12,34,73,74,103,93,30,19,True,True
562,12,35,66,75,90,70,24,-5,True,False
563,12,36,65,95,94,121,29,26,True,True
564,12,37,82,83,124,121,42,38,True,True
565,12,38,80,53,124,96,44,43,True,True
566,12,39,69,47,143,102,74,55,True,True
567,12,40,83,38,102,65,19,27,True,True
568,12,41,84,28,94,66,10,38,True,True
569,12,42,73,52,70,47,-3,-5,False,False
570,12,43,54,35,61,51,7,16,True,True
571,12,44,47,29,78,40,31,11,True,True
572,12,45,54,18,72,42,18,24,True,True
573,12,46,69,29,91,32,22,3,True,True
574,12,47,62,14,66,42,4,28,True,True
575,12,48,32,25,79,35,47,10,True,True
576,13,1,683,709,1513,982,830,273,True,True
577,13,2,542,611,1254,1056,712,445,True,True
578,13,3,378,405,843,919,465,514,True,True
579,13,4,211,290,615,862,404,572,True,True
580,13,5,144,169,496,809,352,640,True,True
581,13,6,104,143,354,764,250,621,True,True
582,13,7,88,123,291,667,203,544,True,True
583,13,8,64,95,237,622,173,527,True,True
584,13,9,104,97,200,517,96,420,True,True
585,13,10,176,101,171,275,-5,174,False,True
586,13,11,319,86,236,189,-83,103,False,True
587,13,12,515,114,693,96,178,-18,True,False
588,13,13,1111,139,1472,115,361,-24,True,False
589,13,14,2186,203,3729,134,1543,-69,True,False
590,13,15,2779,290,4518,132,1739,-158,True,False
591,13,16,3904,370,5244,219,1340,-151,True,False
592,13,17,4544,417,4926,255,382,-162,True,False
593,13,18,5091,559,4934,376,-157,-183,False,False
594,13,19,4351,709,4162,472,-189,-237,False,False
595,13,20,3550,936,3461,634,-89,-302,False,False
596,13,21,2641,961,2645,828,4,-133,True,False
597,13,22,2422,1208,2258,952,-164,-256,False,False
598,13,23,2355,1170,2053,1021,-302,-149,False,False
599,13,24,2584,1306,2107,1041,-477,-265,False,False
600,13,25,2596,1343,2200,1149,-396,-194,False,False
601,13,26,2280,1295,2019,1145,-261,-150,False,False
602,13,27,2110,1259,1945,1016,-165,-243,False,False
603,13,28,2194,1143,2072,1045,-122,-98,False,False
604,13,29,2148,1096,2028,1116,-120,20,False,True
605,13,30,2088,1026,2079,1117,-9,91,False,True
606,13,31,2065,1069,1863,1127,-202,58,False,True
607,13,32,1829,1048,1844,1129,15,81,True,True
608,13,33,1583,1025,1562,1103,-21,78,False,True
609,13,34,1533,967,1256,923,-277,-44,False,False
610,13,35,1783,972,1319,951,-464,-21,False,False
611,13,36,2252,1097,1708,1042,-544,-55,False,False
612,13,37,2448,1200,1980,1172,-468,-28,False,False
613,13,38,2516,1169,2256,1106,-260,-63,False,False
614,13,39,2617,1136,2391,1114,-226,-22,False,False
615,13,40,2760,1138,2446,1006,-314,-132,False,False
616,13,41,2740,972,2546,937,-194,-35,False,False
617,13,42,2595,903,2471,913,-124,10,False,True
618,13,43,2649,938,2692,1012,43,74,True,True
619,13,44,2310,849,2828,1010,518,161,True,True
620,13,45,2206,721,2746,994,540,273,True,True
621,13,46,1677,677,2592,1051,915,374,True,True
622,13,47,1457,670,2423,982,966,312,True,True
623,13,48,1131,568,2160,874,1029,306,True,True
624,14,1,13,16,466,221,453,205,True,True
625,14,2,10,21,420,280,410,259,True,True
626,14,3,13,20,395,328,382,308,True,True
627,14,4,8,17,335,328,327,311,True,True
628,14,5,13,16,230,375,217,359,True,True
629,14,6,7,15,180,294,173,279,True,True
630,14,7,6,21,147,283,141,262,True,True
631,14,8,7,23,114,241,107,218,True,True
632,14,9,2,18,104,224,102,206,True,True
633,14,10,8,13,94,193,86,180,True,True
634,14,11,2,7,66,131,64,124,True,True
635,14,12,7,1,47,78,40,77,True,True
636,14,13,4,4,39,45,35,41,True,True
637,14,14,9,2,39,33,30,31,True,True
638,14,15,17,2,27,36,10,34,True,True
639,14,16,13,5,31,31,18,26,True,True
640,14,17,4,2,35,32,31,30,True,True
641,14,18,10,1,38,27,28,26,True,True
642,14,19,10,2,47,17,37,15,True,True
643,14,20,6,4,47,24,41,20,True,True
644,14,21,6,3,43,30,37,27,True,True
645,14,22,4,6,54,35,50,29,True,True
646,14,23,7,2,45,30,38,28,True,True
647,14,24,6,3,44,44,38,41,True,True
648,14,25,6,4,46,29,40,25,True,True
649,14,26,3,6,42,45,39,39,True,True
650,14,27,3,6,58,33,55,27,True,True
651,14,28,5,2,52,38,47,36,True,True
652,14,29,1,4,54,44,53,40,True,True
653,14,30,6,6,80,47,74,41,True,True
654,14,31,3,3,75,55,72,52,True,True
655,14,32,4,5,65,35,61,30,True,True
656,14,33,6,3,54,45,48,42,True,True
657,14,34,6,2,62,44,56,42,True,True
658,14,35,3,5,70,48,67,43,True,True
659,14,36,5,0,67,45,62,45,True,True
660,14,37,3,6,91,83,88,77,True,True
661,14,38,9,4,131,69,122,65,True,True
662,14,39,7,4,159,74,152,70,True,True
663,14,40,8,7,203,73,195,66,True,True
664,14,41,13,2,244,68,231,66,True,True
665,14,42,9,9,270,74,261,65,True,True
666,14,43,8,3,352,94,344,91,True,True
667,14,44,17,6,435,79,418,73,True,True
668,14,45,12,1,480,121,468,120,True,True
669,14,46,13,3,510,135,497,132,True,True
670,14,47,18,9,490,160,472,151,True,True
671,14,48,32,17,545,176,513,159,True,True
672,15,1,0,0,25,13,25,13,True,True
673,15,2,0,0,14,9,14,9,True,True
674,15,3,0,2,15,10,15,8,True,True
675,15,4,1,0,13,14,12,14,True,True
676,15,5,0,0,10,11,10,11,True,True
677,15,6,0,0,8,9,8,9,True,True
678,15,7,1,0,8,9,7,9,True,True
679,15,8,0,1,5,8,5,7,True,True
680,15,9,0,0,4,8,4,8,True,True
681,15,10,1,0,4,11,3,11,True,True
682,15,11,0,0,4,9,4,9,True,True
683,15,12,1,0,4,7,3,7,True,True
684,15,13,0,0,8,3,8,3,True,True
685,15,14,0,0,3,5,3,5,True,True
686,15,15,0,0,4,9,4,9,True,True
687,15,16,1,0,5,7,4,7,True,True
688,15,17,0,0,9,5,9,5,True,True
689,15,18,0,0,5,0,5,0,True,False
690,15,19,1,0,5,2,4,2,True,True
691,15,20,1,0,6,3,5,3,True,True
692,15,21,0,0,6,3,6,3,True,True
693,15,22,0,0,5,2,5,2,True,True
694,15,23,0,1,4,7,4,6,True,True
695,15,24,0,0,6,4,6,4,True,True
696,15,25,0,0,7,8,7,8,True,True
697,15,26,0,1,5,4,5,3,True,True
698,15,27,1,0,8,11,7,11,True,True
699,15,28,1,0,12,8,11,8,True,True
700,15,29,0,0,9,8,9,8,True,True
701,15,30,0,0,10,4,10,4,True,True
702,15,31,1,0,22,5,21,5,True,True
703,15,32,0,0,13,3,13,3,True,True
704,15,33,0,0,8,5,8,5,True,True
705,15,34,0,0,8,3,8,3,True,True
706,15,35,0,0,10,7,10,7,True,True
707,15,36,0,0,7,9,7,9,True,True
708,15,37,1,0,20,6,19,6,True,True
709,15,38,0,0,12,12,12,12,True,True
710,15,39,0,0,16,9,16,9,True,True
711,15,40,0,0,16,4,16,4,True,True
712,15,41,0,0,19,10,19,10,True,True
713,15,42,0,1,28,5,28,4,True,True
714,15,43,0,1,26,12,26,11,True,True
715,15,44,1,1,26,11,25,10,True,True
716,15,45,0,2,28,11,28,9,True,True
717,15,46,0,2,33,14,33,12,True,True
718,15,47,1,2,33,13,32,11,True,True
719,15,48,0,0,22,18,22,18,True,True
720,16,1,0,1,46,22,46,21,True,True
721,16,2,1,1,54,22,53,21,True,True
722,16,3,0,3,41,40,41,37,True,True
723,16,4,1,2,29,44,28,42,True,True
724,16,5,1,2,30,43,29,41,True,True
725,16,6,1,0,26,40,25,40,True,True
726,16,7,0,0,13,30,13,30,True,True
727,16,8,0,0,8,31,8,31,True,True
728,16,9,0,2,7,25,7,23,True,True
729,16,10,0,0,11,10,11,10,True,True
730,16,11,0,0,8,18,8,18,True,True
731,16,12,0,1,8,9,8,8,True,True
732,16,13,0,1,13,8,13,7,True,True
733,16,14,0,1,9,5,9,4,True,True
734,16,15,0,1,6,6,6,5,True,True
735,16,16,2,0,8,4,6,4,True,True
736,16,17,0,1,13,4,13,3,True,True
737,16,18,0,0,16,4,16,4,True,True
738,16,19,1,0,17,8,16,8,True,True
739,16,20,1,0,16,9,15,9,True,True
740,16,21,1,0,7,9,6,9,True,True
741,16,22,2,0,9,5,7,5,True,True
742,16,23,1,1,13,4,12,3,True,True
743,16,24,2,0,9,6,7,6,True,True
744,16,25,0,0,10,4,10,4,True,True
745,16,26,0,0,11,10,11,10,True,True
746,16,27,0,0,9,5,9,5,True,True
747,16,28,1,0,15,10,14,10,True,True
748,16,29,0,0,9,10,9,10,True,True
749,16,30,0,1,21,17,21,16,True,True
750,16,31,1,1,21,7,20,6,True,True
751,16,32,1,1,23,8,22,7,True,True
752,16,33,1,0,18,8,17,8,True,True
753,16,34,0,0,26,5,26,5,True,True
754,16,35,0,1,24,7,24,6,True,True
755,16,36,0,1,18,20,18,19,True,True
756,16,37,2,1,29,10,27,9,True,True
757,16,38,1,0,15,13,14,13,True,True
758,16,39,0,0,30,12,30,12,True,True
759,16,40,1,0,41,10,40,10,True,True
760,16,41,3,0,34,10,31,10,True,True
761,16,42,3,0,34,8,31,8,True,True
762,16,43,2,0,49,9,47,9,True,True
763,16,44,2,0,52,16,50,16,True,True
764,16,45,1,0,44,20,43,20,True,True
765,16,46,1,0,53,17,52,17,True,True
766,16,47,3,1,65,19,62,18,True,True
767,16,48,0,1,71,20,71,19,True,True
768,17,1,201,182,1029,487,828,305,True,True
769,17,2,188,208,1133,639,945,431,True,True
770,17,3,148,211,969,690,821,479,True,True
771,17,4,102,197,786,806,684,609,True,True
772,17,5,89,173,704,785,615,612,True,True
773,17,6,70,177,589,828,519,651,True,True
774,17,7,60,132,447,815,387,683,True,True
775,17,8,62,117,429,705,367,588,True,True
776,17,9,58,121,393,636,335,515,True,True
777,17,10,26,87,299,518,273,431,True,True
778,17,11,20,48,173,330,153,282,True,True
779,17,12,26,25,120,201,94,176,True,True
780,17,13,14,21,109,124,95,103,True,True
781,17,14,15,15,89,85,74,70,True,True
782,17,15,16,8,77,68,61,60,True,True
783,17,16,10,10,46,44,36,34,True,True
784,17,17,10,6,58,41,48,35,True,True
785,17,18,13,11,65,40,52,29,True,True
786,17,19,9,6,71,34,62,28,True,True
787,17,20,13,16,79,57,66,41,True,True
788,17,21,10,11,69,56,59,45,True,True
789,17,22,9,19,66,47,57,28,True,True
790,17,23,11,24,74,67,63,43,True,True
791,17,24,17,23,78,72,61,49,True,True
792,17,25,8,19,95,53,87,34,True,True
793,17,26,11,16,109,65,98,49,True,True
794,17,27,18,15,110,68,92,53,True,True
795,17,28,18,16,106,61,88,45,True,True
796,17,29,12,16,112,86,100,70,True,True
797,17,30,22,24,118,74,96,50,True,True
798,17,31,20,26,137,89,117,63,True,True
799,17,32,19,20,117,76,98,56,True,True
800,17,33,14,14,130,101,116,87,True,True
801,17,34,15,21,120,91,105,70,True,True
802,17,35,16,14,97,103,81,89,True,True
803,17,36,33,34,173,110,140,76,True,True
804,17,37,36,34,192,140,156,106,True,True
805,17,38,39,29,234,121,195,92,True,True
806,17,39,41,30,272,151,231,121,True,True
807,17,40,59,59,303,153,244,94,True,True
808,17,41,72,56,314,163,242,107,True,True
809,17,42,99,45,414,171,315,126,True,True
810,17,43,122,70,559,204,437,134,True,True
811,17,44,135,70,626,230,491,160,True,True
812,17,45,126,82,631,292,505,210,True,True
813,17,46,153,118,809,323,656,205,True,True
814,17,47,161,133,853,347,692,214,True,True
815,17,48,215,133,1034,414,819,281,True,True
816,18,1,4,1,47,21,43,20,True,True
817,18,2,1,0,50,39,49,39,True,True
818,18,3,3,2,49,36,46,34,True,True
819,18,4,2,1,45,42,43,41,True,True
820,18,5,0,2,44,38,44,36,True,True
821,18,6,0,1,36,43,36,42,True,True
822,18,7,0,4,33,38,33,34,True,True
823,18,8,2,1,23,41,21,40,True,True
824,18,9,1,1,19,59,18,58,True,True
825,18,10,4,1,30,36,26,35,True,True
826,18,11,4,1,23,27,19,26,True,True
827,18,12,3,2,14,25,11,23,True,True
828,18,13,0,0,11,18,11,18,True,True
829,18,14,2,0,6,11,4,11,True,True
830,18,15,0,0,4,12,4,12,True,True
831,18,16,1,0,9,7,8,7,True,True
832,18,17,2,0,10,8,8,8,True,True
833,18,18,1,0,7,11,6,11,True,True
834,18,19,1,1,14,10,13,9,True,True
835,18,20,0,0,8,6,8,6,True,True
836,18,21,3,1,7,13,4,12,True,True
837,18,22,1,1,14,7,13,6,True,True
838,18,23,0,2,9,8,9,6,True,True
839,18,24,1,1,7,3,6,2,True,True
840,18,25,0,2,9,6,9,4,True,True
841,18,26,2,1,12,5,10,4,True,True
842,18,27,1,1,10,5,9,4,True,True
843,18,28,1,0,8,5,7,5,True,True
844,18,29,0,0,14,6,14,6,True,True
845,18,30,2,0,12,3,10,3,True,True
846,18,31,0,1,10,10,10,9,True,True
847,18,32,7,0,13,14,6,14,True,True
848,18,33,1,0,12,7,11,7,True,True
849,18,34,0,0,9,14,9,14,True,True
850,18,35,1,0,3,6,2,6,True,True
851,18,36,0,1,8,8,8,7,True,True
852,18,37,0,0,9,10,9,10,True,True
853,18,38,1,0,11,7,10,7,True,True
854,18,39,2,2,20,10,18,8,True,True
855,18,40,0,1,21,13,21,12,True,True
856,18,41,0,1,26,10,26,9,True,True
857,18,42,0,0,25,7,25,7,True,True
858,18,43,1,1,25,12,24,11,True,True
859,18,44,3,1,29,13,26,12,True,True
860,18,45,1,1,33,13,32,12,True,True
861,18,46,1,1,35,18,34,17,True,True
862,18,47,2,0,39,18,37,18,True,True
863,18,48,5,2,37,22,32,20,True,True
864,19,1,0,1,15,5,15,4,True,True
865,19,2,2,2,19,8,17,6,True,True
866,19,3,0,1,11,8,11,7,True,True
867,19,4,1,0,9,5,8,5,True,True
868,19,5,0,2,8,3,8,1,True,True
869,19,6,1,0,7,6,6,6,True,True
870,19,7,0,1,3,6,3,5,True,True
871,19,8,1,2,2,6,1,4,True,True
872,19,9,4,1,6,8,2,7,True,True
873,19,10,3,3,5,6,2,3,True,True
874,19,11,5,0,3,3,-2,3,False,True
875,19,12,2,3,4,2,2,-1,True,False
876,19,13,4,0,6,5,2,5,True,True
877,19,14,1,0,3,2,2,2,True,True
878,19,15,5,2,2,3,-3,1,False,True
879,19,16,2,0,4,2,2,2,True,True
880,19,17,2,0,4,2,2,2,True,True
881,19,18,5,1,5,0,0,-1,False,False
882,19,19,5,1,13,1,8,0,True,False
883,19,20,4,0,10,2,6,2,True,True
884,19,21,3,3,8,4,5,1,True,True
885,19,22,3,2,8,1,5,-1,True,False
886,19,23,1,0,1,4,0,4,False,True
887,19,24,3,1,2,6,-1,5,False,True
888,19,25,0,1,3,3,3,2,True,True
889,19,26,1,1,2,4,1,3,True,True
890,19,27,1,1,6,2,5,1,True,True
891,19,28,2,1,10,4,8,3,True,True
892,19,29,7,3,15,3,8,0,True,False
893,19,30,9,2,19,6,10,4,True,True
894,19,31,4,2,8,7,4,5,True,True
895,19,32,3,1,12,4,9,3,True,True
896,19,33,2,1,10,7,8,6,True,True
897,19,34,0,0,7,6,7,6,True,True
898,19,35,1,0,8,4,7,4,True,True
899,19,36,0,1,7,6,7,5,True,True
900,19,37,0,0,6,7,6,7,True,True
901,19,38,1,0,9,3,8,3,True,True
902,19,39,0,0,10,3,10,3,True,True
903,19,40,0,1,10,5,10,4,True,True
904,19,41,4,1,9,1,5,0,True,False
905,19,42,2,0,12,4,10,4,True,True
906,19,43,1,0,15,6,14,6,True,True
907,19,44,3,1,19,8,16,7,True,True
908,19,45,0,0,14,8,14,8,True,True
909,19,46,5,1,22,10,17,9,True,True
910,19,47,2,1,23,8,21,7,True,True
911,19,48,0,1,24,6,24,5,True,True
912,20,1,1,2,28,15,27,13,True,True
913,20,2,0,1,31,27,31,26,True,True
914,20,3,0,1,21,19,21,18,True,True
915,20,4,0,2,25,36,25,34,True,True
916,20,5,0,0,16,28,16,28,True,True
917,20,6,0,5,24,39,24,34,True,True
918,20,7,1,0,13,46,12,46,True,True
919,20,8,0,7,9,40,9,33,True,True
920,20,9,0,1,7,30,7,29,True,True
921,20,10,0,3,8,29,8,26,True,True
922,20,11,0,1,1,12,1,11,True,True
923,20,12,0,0,3,14,3,14,True,True
924,20,13,0,0,3,1,3,1,True,True
925,20,14,0,0,4,2,4,2,True,True
926,20,15,2,0,7,3,5,3,True,True
927,20,16,1,0,7,3,6,3,True,True
928,20,17,0,0,12,8,12,8,True,True
929,20,18,0,2,18,3,18,1,True,True
930,20,19,1,0,12,4,11,4,True,True
931,20,20,0,0,12,7,12,7,True,True
932,20,21,0,2,16,9,16,7,True,True
933,20,22,1,2,13,16,12,14,True,True
934,20,23,0,1,5,8,5,7,True,True
935,20,24,0,0,25,9,25,9,True,True
936,20,25,1,1,15,14,14,13,True,True
937,20,26,2,1,23,9,21,8,True,True
938,20,27,2,1,14,12,12,11,True,True
939,20,28,1,0,10,9,9,9,True,True
940,20,29,0,1,14,4,14,3,True,True
941,20,30,1,1,8,8,7,7,True,True
942,20,31,2,2,10,7,8,5,True,True
943,20,32,0,0,8,7,8,7,True,True
944,20,33,0,0,8,3,8,3,True,True
945,20,34,0,0,6,6,6,6,True,True
946,20,35,0,0,5,6,5,6,True,True
947,20,36,1,1,9,14,8,13,True,True
948,20,37,0,0,8,11,8,11,True,True
949,20,38,0,0,10,9,10,9,True,True
950,20,39,0,1,10,4,10,3,True,True
951,20,40,0,0,15,4,15,4,True,True
952,20,41,1,0,13,11,12,11,True,True
953,20,42,0,0,15,9,15,9,True,True
954,20,43,0,0,17,5,17,5,True,True
955,20,44,0,0,16,15,16,15,True,True
956,20,45,0,0,31,11,31,11,True,True
957,20,46,0,0,17,10,17,10,True,True
958,20,47,1,0,26,8,25,8,True,True
959,20,48,0,0,28,8,28,8,True,True
960,21,1,1,1,65,22,64,21,True,True
961,21,2,1,3,60,41,59,38,True,True
962,21,3,3,3,52,33,49,30,True,True
963,21,4,0,2,47,47,47,45,True,True
964,21,5,1,1,31,34,30,33,True,True
965,21,6,0,3,27,42,27,39,True,True
966,21,7,0,1,30,55,30,54,True,True
967,21,8,4,3,22,49,18,46,True,True
968,21,9,0,0,13,42,13,42,True,True
969,21,10,1,2,19,37,18,35,True,True
970,21,11,3,3,8,32,5,29,True,True
971,21,12,5,2,7,24,2,22,True,True
972,21,13,2,0,7,6,5,6,True,True
973,21,14,7,1,10,5,3,4,True,True
974,21,15,4,1,10,6,6,5,True,True
975,21,16,4,0,8,11,4,11,True,True
976,21,17,2,0,12,5,10,5,True,True
977,21,18,2,1,8,4,6,3,True,True
978,21,19,3,0,12,8,9,8,True,True
979,21,20,0,0,8,4,8,4,True,True
980,21,21,3,0,6,5,3,5,True,True
981,21,22,1,0,12,4,11,4,True,True
982,21,23,1,2,9,8,8,6,True,True
983,21,24,0,3,10,3,10,0,True,False
984,21,25,3,2,5,7,2,5,True,True
985,21,26,2,0,8,4,6,4,True,True
986,21,27,1,0,9,9,8,9,True,True
987,21,28,5,1,17,5,12,4,True,True
988,21,29,1,1,12,12,11,11,True,True
989,21,30,0,0,18,5,18,5,True,True
990,21,31,2,0,17,10,15,10,True,True
991,21,32,0,1,9,6,9,5,True,True
992,21,33,0,0,15,5,15,5,True,True
993,21,34,1,0,5,8,4,8,True,True
994,21,35,4,0,12,5,8,5,True,True
995,21,36,4,0,12,9,8,9,True,True
996,21,37,1,0,8,11,7,11,True,True
997,21,38,1,0,19,16,18,16,True,True
998,21,39,2,0,28,6,26,6,True,True
999,21,40,2,0,21,9,19,9,True,True
1000,21,41,1,0,23,13,22,13,True,True
1001,21,42,4,2,34,10,30,8,True,True
1002,21,43,2,3,38,12,36,9,True,True
1003,21,44,0,1,53,16,53,15,True,True
1004,21,45,1,0,64,13,63,13,True,True
1005,21,46,0,1,65,14,65,13,True,True
1006,21,47,5,2,62,20,57,18,True,True
1007,21,48,0,0,64,15,64,15,True,True
1008,22,1,3,1,94,37,91,36,True,True
1009,22,2,3,5,86,54,83,49,True,True
1010,22,3,4,0,97,62,93,62,True,True
1011,22,4,5,3,82,69,77,66,True,True
1012,22,5,2,2,59,77,57,75,True,True
1013,22,6,0,3,57,80,57,77,True,True
1014,22,7,2,8,37,71,35,63,True,True
1015,22,8,4,2,27,66,23,64,True,True
1016,22,9,2,9,23,75,21,66,True,True
1017,22,10,1,2,30,58,29,56,True,True
1018,22,11,1,5,17,43,16,38,True,True
1019,22,12,4,0,16,27,12,27,True,True
1020,22,13,1,2,26,20,25,18,True,True
1021,22,14,1,2,14,17,13,15,True,True
1022,22,15,4,1,7,13,3,12,True,True
1023,22,16,6,1,11,13,5,12,True,True
1024,22,17,1,5,8,14,7,9,True,True
1025,22,18,2,1,7,3,5,2,True,True
1026,22,19,1,7,9,12,8,5,True,True
1027,22,20,3,1,9,6,6,5,True,True
1028,22,21,0,1,18,5,18,4,True,True
1029,22,22,0,1,14,10,14,9,True,True
1030,22,23,1,1,12,8,11,7,True,True
1031,22,24,1,1,9,10,8,9,True,True
1032,22,25,4,1,14,8,10,7,True,True
1033,22,26,3,3,21,8,18,5,True,True
1034,22,27,3,2,16,16,13,14,True,True
1035,22,28,1,2,14,11,13,9,True,True
1036,22,29,6,0,21,13,15,13,True,True
1037,22,30,2,2,17,16,15,14,True,True
1038,22,31,4,1,16,16,12,15,True,True
1039,22,32,4,0,15,9,11,9,True,True
1040,22,33,5,0,22,6,17,6,True,True
1041,22,34,3,0,11,10,8,10,True,True
1042,22,35,1,2,14,5,13,3,True,True
1043,22,36,3,2,19,6,16,4,True,True
1044,22,37,3,1,23,12,20,11,True,True
1045,22,38,2,0,30,6,28,6,True,True
1046,22,39,4,0,25,12,21,12,True,True
1047,22,40,1,1,40,10,39,9,True,True
1048,22,41,0,2,46,15,46,13,True,True
1049,22,42,0,3,49,17,49,14,True,True
1050,22,43,2,0,63,15,61,15,True,True
1051,22,44,2,0,64,27,62,27,True,True
1052,22,45,4,1,87,12,83,11,True,True
1053,22,46,1,2,79,21,78,19,True,True
1054,22,47,1,1,99,25,98,24,True,True
1055,22,48,2,1,89,27,87,26,True,True
1056,23,1,0,3,13,9,13,6,True,True
1057,23,2,0,1,9,9,9,8,True,True
1058,23,3,0,1,7,3,7,2,True,True
1059,23,4,0,0,6,6,6,6,True,True
1060,23,5,0,0,5,6,5,6,True,True
1061,23,6,0,0,1,1,1,1,True,True
1062,23,7,0,1,1,6,1,5,True,True
1063,23,8,1,1,3,4,2,3,True,True
1064,23,9,1,0,4,1,3,1,True,True
1065,23,10,1,0,2,1,1,1,True,True
1066,23,11,0,0,0,0,0,0,False,False
1067,23,12,0,0,0,2,0,2,False,True
1068,23,13,0,0,0,1,0,1,False,True
1069,23,14,0,0,0,3,0,3,False,True
1070,23,15,0,0,0,2,0,2,False,True
1071,23,16,0,0,0,0,0,0,False,False
1072,23,17,0,0,0,1,0,1,False,True
1073,23,18,0,0,0,0,0,0,False,False
1074,23,19,0,0,3,1,3,1,True,True
1075,23,20,1,0,4,2,3,2,True,True
1076,23,21,0,0,1,2,1,2,True,True
1077,23,22,1,1,2,1,1,0,True,False
1078,23,23,0,1,2,1,2,0,True,False
1079,23,24,0,0,3,0,3,0,True,False
1080,23,25,0,0,2,0,2,0,True,False
1081,23,26,0,0,6,1,6,1,True,True
1082,23,27,0,0,3,0,3,0,True,False
1083,23,28,0,0,2,3,2,3,True,True
1084,23,29,0,0,3,2,3,2,True,True
1085,23,30,0,0,4,1,4,1,True,True
1086,23,31,0,1,3,0,3,-1,True,False
1087,23,32,0,0,2,2,2,2,True,True
1088,23,33,0,0,4,2,4,2,True,True
1089,23,34,1,0,1,2,0,2,False,True
1090,23,35,2,0,4,3,2,3,True,True
1091,23,36,0,0,2,1,2,1,True,True
1092,23,37,2,0,7,0,5,0,True,False
1093,23,38,1,0,5,2,4,2,True,True
1094,23,39,2,0,6,2,4,2,True,True
1095,23,40,2,0,9,0,7,0,True,False
1096,23,41,4,0,7,2,3,2,True,True
1097,23,42,2,0,7,0,5,0,True,False
1098,23,43,3,0,8,0,5,0,True,False
1099,23,44,2,0,13,2,11,2,True,True
1100,23,45,0,0,8,1,8,1,True,True
1101,23,46,0,1,16,2,16,1,True,True
1102,23,47,0,0,15,1,15,1,True,True
1103,23,48,0,0,17,0,17,0,True,False
1104,24,1,391,340,813,496,422,156,True,True
1105,24,2,333,317,733,560,400,243,True,True
1106,24,3,213,314,555,551,342,237,True,True
1107,24,4,183,258,421,551,238,293,True,True
1108,24,5,183,213,360,555,177,342,True,True
1109,24,6,136,203,286,510,150,307,True,True
1110,24,7,106,144,212,457,106,313,True,True
1111,24,8,96,141,173,434,77,293,True,True
1112,24,9,113,123,145,340,32,217,True,True
1113,24,10,150,97,115,259,-35,162,False,True
1114,24,11,156,76,74,129,-82,53,False,True
1115,24,12,224,68,117,75,-107,7,False,True
1116,24,13,325,110,87,81,-238,-29,False,False
1117,24,14,547,148,113,68,-434,-80,False,False
1118,24,15,802,146,200,80,-602,-66,False,False
1119,24,16,1044,199,434,124,-610,-75,False,False
1120,24,17,1180,254,554,106,-626,-148,False,False
1121,24,18,1155,307,431,149,-724,-158,False,False
1122,24,19,877,379,284,176,-593,-203,False,False
1123,24,20,811,443,283,236,-528,-207,False,False
1124,24,21,762,427,368,258,-394,-169,False,False
1125,24,22,686,451,373,261,-313,-190,False,False
1126,24,23,612,446,386,314,-226,-132,False,False
1127,24,24,670,441,511,300,-159,-141,False,False
1128,24,25,609,397,500,321,-109,-76,False,False
1129,24,26,604,423,505,349,-99,-74,False,False
1130,24,27,596,433,507,311,-89,-122,False,False
1131,24,28,586,396,473,305,-113,-91,False,False
1132,24,29,609,398,529,321,-80,-77,False,False
1133,24,30,650,383,550,362,-100,-21,False,False
1134,24,31,598,338,649,313,51,-25,True,False
1135,24,32,612,366,679,324,67,-42,True,False
1136,24,33,564,321,662,356,98,35,True,True
1137,24,34,555,347,616,324,61,-23,True,False
1138,24,35,646,328,704,322,58,-6,True,False
1139,24,36,777,362,826,363,49,1,True,True
1140,24,37,840,362,962,396,122,34,True,True
1141,24,38,850,403,1118,406,268,3,True,True
1142,24,39,823,371,1056,377,233,6,True,True
1143,24,40,757,339,1014,338,257,-1,True,False
1144,24,41,727,339,1050,357,323,18,True,True
1145,24,42,637,299,1003,336,366,37,True,True
1146,24,43,648,293,1079,394,431,101,True,True
1147,24,44,674,270,1097,422,423,152,True,True
1148,24,45,617,290,1154,415,537,125,True,True
1149,24,46,568,268,1117,423,549,155,True,True
1150,24,47,578,329,1025,467,447,138,True,True
1151,24,48,544,292,981,432,437,140,True,True
1152,25,1,662,621,929,483,267,-138,True,False
1153,25,2,562,649,809,597,247,-52,True,False
1154,25,3,417,602,719,599,302,-3,True,False
1155,25,4,290,467,454,607,164,140,True,True
1156,25,5,240,431,331,562,91,131,True,True
1157,25,6,173,298,236,475,63,177,True,True
1158,25,7,159,290,209,381,50,91,True,True
1159,25,8,106,213,149,335,43,122,True,True
1160,25,9,96,198,129,299,33,101,True,True
1161,25,10,84,105,109,210,25,105,True,True
1162,25,11,102,78,83,121,-19,43,False,True
1163,25,12,170,55,62,84,-108,29,False,True
1164,25,13,200,68,74,56,-126,-12,False,False
1165,25,14,299,58,90,43,-209,-15,False,False
1166,25,15,389,66,113,50,-276,-16,False,False
1167,25,16,292,89,169,61,-123,-28,False,False
1168,25,17,253,97,160,61,-93,-36,False,False
1169,25,18,207,81,193,102,-14,21,False,True
1170,25,19,209,131,165,107,-44,-24,False,False
1171,25,20,170,127,154,96,-16,-31,False,False
1172,25,21,140,141,157,128,17,-13,True,False
1173,25,22,155,160,144,160,-11,0,False,False
1174,25,23,135,164,145,180,10,16,True,True
1175,25,24,140,170,159,182,19,12,True,True
1176,25,25,153,161,175,183,22,22,True,True
1177,25,26,142,167,186,159,44,-8,True,False
1178,25,27,141,181,174,183,33,2,True,True
1179,25,28,124,159,180,150,56,-9,True,False
1180,25,29,160,161,213,139,53,-22,True,False
1181,25,30,157,190,190,198,33,8,True,True
1182,25,31,162,207,198,183,36,-24,True,False
1183,25,32,180,200,199,179,19,-21,True,False
1184,25,33,182,169,180,180,-2,11,False,True
1185,25,34,189,205,195,181,6,-24,True,False
1186,25,35,259,229,224,203,-35,-26,False,False
1187,25,36,297,267,282,201,-15,-66,False,False
1188,25,37,309,255,349,239,40,-16,True,False
1189,25,38,339,261,408,215,69,-46,True,False
1190,25,39,369,291,521,326,152,35,True,True
1191,25,40,436,266,611,274,175,8,True,True
1192,25,41,433,265,640,276,207,11,True,True
1193,25,42,488,240,737,267,249,27,True,True
1194,25,43,542,266,853,282,311,16,True,True
1195,25,44,607,275,952,285,345,10,True,True
1196,25,45,669,317,1023,286,354,-31,True,False
1197,25,46,718,366,1090,332,372,-34,True,False
1198,25,47,727,422,999,386,272,-36,True,False
1199,25,48,846,447,1075,379,229,-68,True,False
1200,26,1,21,20,80,45,59,25,True,True
1201,26,2,21,14,83,36,62,22,True,True
1202,26,3,8,15,58,42,50,27,True,True
1203,26,4,16,15,61,48,45,33,True,True
1204,26,5,15,17,35,58,20,41,True,True
1205,26,6,10,13,46,55,36,42,True,True
1206,26,7,9,9,36,51,27,42,True,True
1207,26,8,8,16,32,51,24,35,True,True
1208,26,9,15,16,34,54,19,38,True,True
1209,26,10,13,16,29,47,16,31,True,True
1210,26,11,15,22,22,38,7,16,True,True
1211,26,12,15,13,44,26,29,13,True,True
1212,26,13,8,11,37,18,29,7,True,True
1213,26,14,8,4,59,22,51,18,True,True
1214,26,15,9,1,45,14,36,13,True,True
1215,26,16,3,0,25,16,22,16,True,True
1216,26,17,5,3,43,15,38,12,True,True
1217,26,18,7,1,40,10,33,9,True,True
1218,26,19,13,8,52,22,39,14,True,True
1219,26,20,15,7,28,15,13,8,True,True
1220,26,21,16,5,51,9,35,4,True,True
1221,26,22,21,4,52,9,31,5,True,True
1222,26,23,27,12,68,22,41,10,True,True
1223,26,24,24,9,55,21,31,12,True,True
1224,26,25,30,12,59,17,29,5,True,True
1225,26,26,26,18,66,27,40,9,True,True
1226,26,27,19,16,64,34,45,18,True,True
1227,26,28,20,17,61,25,41,8,True,True
1228,26,29,26,14,67,22,41,8,True,True
1229,26,30,31,15,78,23,47,8,True,True
1230,26,31,25,13,77,22,52,9,True,True
1231,26,32,34,12,66,28,32,16,True,True
1232,26,33,36,19,74,34,38,15,True,True
1233,26,34,37,19,73,29,36,10,True,True
1234,26,35,32,17,57,37,25,20,True,True
1235,26,36,34,14,66,27,32,13,True,True
1236,26,37,14,5,58,21,44,16,True,True
1237,26,38,27,9,53,27,26,18,True,True
1238,26,39,26,15,78,25,52,10,True,True
1239,26,40,34,10,76,29,42,19,True,True
1240,26,41,32,8,88,27,56,19,True,True
1241,26,42,35,12,81,20,46,8,True,True
1242,26,43,24,13,79,30,55,17,True,True
1243,26,44,29,18,69,29,40,11,True,True
1244,26,45,26,11,84,29,58,18,True,True
1245,26,46,21,15,70,31,49,16,True,True
1246,26,47,32,11,86,30,54,19,True,True
1247,26,48,29,14,84,29,55,15,True,True
1248,27,1,1,0,4,0,3,0,True,False
1249,27,2,0,0,3,3,3,3,True,True
1250,27,3,1,0,3,0,2,0,True,False
1251,27,4,0,0,2,1,2,1,True,True
1252,27,5,0,0,0,2,0,2,False,True
1253,27,6,0,0,0,2,0,2,False,True
1254,27,7,0,0,2,2,2,2,True,True
1255,27,8,0,0,0,0,0,0,False,False
1256,27,9,0,0,0,0,0,0,False,False
1257,27,10,0,1,0,2,0,1,False,True
1258,27,11,0,0,0,0,0,0,False,False
1259,27,12,0,0,1,0,1,0,True,False
1260,27,13,1,0,0,0,-1,0,False,False
1261,27,14,0,0,0,0,0,0,False,False
1262,27,15,0,0,0,0,0,0,False,False
1263,27,16,0,0,1,0,1,0,True,False
1264,27,17,0,0,0,0,0,0,False,False
1265,27,18,0,0,0,1,0,1,False,True
1266,27,19,0,0,0,0,0,0,False,False
1267,27,20,0,2,0,2,0,0,False,False
1268,27,21,0,0,0,2,0,2,False,True
1269,27,22,0,0,0,1,0,1,False,True
1270,27,23,0,1,2,0,2,-1,True,False
1271,27,24,0,0,1,0,1,0,True,False
1272,27,25,0,0,0,1,0,1,False,True
1273,27,26,0,0,1,1,1,1,True,True
1274,27,27,0,0,0,1,0,1,False,True
1275,27,28,0,0,1,1,1,1,True,True
1276,27,29,0,0,1,1,1,1,True,True
1277,27,30,0,0,1,1,1,1,True,True
1278,27,31,0,0,1,4,1,4,True,True
1279,27,32,0,0,0,0,0,0,False,False
1280,27,33,0,0,1,1,1,1,True,True
1281,27,34,0,0,3,1,3,1,True,True
1282,27,35,0,0,1,1,1,1,True,True
1283,27,36,0,0,1,0,1,0,True,False
1284,27,37,0,0,0,0,0,0,False,False
1285,27,38,0,0,3,0,3,0,True,False
1286,27,39,0,0,1,0,1,0,True,False
1287,27,40,0,0,4,0,4,0,True,False
1288,27,41,0,0,1,1,1,1,True,True
1289,27,42,0,0,2,2,2,2,True,True
1290,27,43,0,0,2,0,2,0,True,False
1291,27,44,0,0,1,1,1,1,True,True
1292,27,45,0,0,2,1,2,1,True,True
1293,27,46,0,0,3,2,3,2,True,True
1294,27,47,0,0,1,0,1,0,True,False
1295,27,48,0,0,3,0,3,0,True,False
1296,28,1,9,5,118,41,109,36,True,True
1297,28,2,9,2,111,49,102,47,True,True
1298,28,3,7,2,105,68,98,66,True,True
1299,28,4,9,7,74,63,65,56,True,True
1300,28,5,9,4,54,66,45,62,True,True
1301,28,6,3,1,40,62,37,61,True,True
1302,28,7,5,5,38,53,33,48,True,True
1303,28,8,4,2,36,60,32,58,True,True
1304,28,9,7,2,17,42,10,40,True,True
1305,28,10,11,4,27,42,16,38,True,True
1306,28,11,14,3,28,36,14,33,True,True
1307,28,12,12,8,18,22,6,14,True,True
1308,28,13,8,10,23,18,15,8,True,True
1309,28,14,17,9,28,9,11,0,True,False
1310,28,15,22,8,24,9,2,1,True,True
1311,28,16,12,7,19,10,7,3,True,True
1312,28,17,18,9,36,14,18,5,True,True
1313,28,18,8,12,18,14,10,2,True,True
1314,28,19,11,5,22,17,11,12,True,True
1315,28,20,10,8,23,15,13,7,True,True
1316,28,21,12,13,27,14,15,1,True,True
1317,28,22,12,11,24,8,12,-3,True,False
1318,28,23,14,4,22,15,8,11,True,True
1319,28,24,18,8,19,19,1,11,True,True
1320,28,25,13,8,22,13,9,5,True,True
1321,28,26,16,8,25,20,9,12,True,True
1322,28,27,9,12,23,16,14,4,True,True
1323,28,28,13,12,26,22,13,10,True,True
1324,28,29,20,7,37,16,17,9,True,True
1325,28,30,17,10,34,19,17,9,True,True
1326,28,31,15,9,27,13,12,4,True,True
1327,28,32,12,9,39,12,27,3,True,True
1328,28,33,21,13,46,18,25,5,True,True
1329,28,34,16,7,38,27,22,20,True,True
1330,28,35,11,10,32,20,21,10,True,True
1331,28,36,15,7,27,21,12,14,True,True
1332,28,37,13,2,38,16,25,14,True,True
1333,28,38,14,8,42,21,28,13,True,True
1334,28,39,15,4,41,18,26,14,True,True
1335,28,40,13,10,50,23,37,13,True,True
1336,28,41,12,6,42,23,30,17,True,True
1337,28,42,9,8,72,33,63,25,True,True
1338,28,43,14,10,85,34,71,24,True,True
1339,28,44,7,6,88,34,81,28,True,True
1340,28,45,12,7,76,34,64,27,True,True
1341,28,46,11,13,133,43,122,30,True,True
1342,28,47,10,3,138,26,128,23,True,True
1343,28,48,9,9,119,46,110,37,True,True
1344,29,1,0,2,28,19,28,17,True,True
1345,29,2,1,1,28,12,27,11,True,True
1346,29,3,2,0,27,20,25,20,True,True
1347,29,4,5,3,28,19,23,16,True,True
1348,29,5,4,1,23,20,19,19,True,True
1349,29,6,1,4,16,24,15,20,True,True
1350,29,7,1,1,8,12,7,11,True,True
1351,29,8,0,2,11,16,11,14,True,True
1352,29,9,0,2,8,15,8,13,True,True
1353,29,10,2,3,14,33,12,30,True,True
1354,29,11,6,1,9,15,3,14,True,True
1355,29,12,9,2,6,11,-3,9,False,True
1356,29,13,2,0,11,7,9,7,True,True
1357,29,14,0,0,7,6,7,6,True,True
1358,29,15,2,2,5,11,3,9,True,True
1359,29,16,0,1,9,3,9,2,True,True
1360,29,17,1,1,10,5,9,4,True,True
1361,29,18,2,0,4,3,2,3,True,True
1362,29,19,5,0,16,3,11,3,True,True
1363,29,20,3,0,8,3,5,3,True,True
1364,29,21,4,0,13,4,9,4,True,True
1365,29,22,0,1,6,10,6,9,True,True
1366,29,23,1,1,15,2,14,1,True,True
1367,29,24,1,3,9,6,8,3,True,True
1368,29,25,0,2,5,8,5,6,True,True
1369,29,26,2,0,15,5,13,5,True,True
1370,29,27,1,1,15,12,14,11,True,True
1371,29,28,2,0,14,8,12,8,True,True
1372,29,29,0,1,23,14,23,13,True,True
1373,29,30,0,0,14,12,14,12,True,True
1374,29,31,2,1,19,15,17,14,True,True
1375,29,32,1,2,23,9,22,7,True,True
1376,29,33,1,2,17,11,16,9,True,True
1377,29,34,1,1,6,4,5,3,True,True
1378,29,35,1,0,13,4,12,4,True,True
1379,29,36,1,0,16,8,15,8,True,True
1380,29,37,1,1,14,6,13,5,True,True
1381,29,38,0,1,19,16,19,15,True,True
1382,29,39,1,0,29,18,28,18,True,True
1383,29,40,0,1,34,10,34,9,True,True
1384,29,41,1,0,17,8,16,8,True,True
1385,29,42,0,0,25,12,25,12,True,True
1386,29,43,1,1,33,15,32,14,True,True
1387,29,44,0,0,23,12,23,12,True,True
1388,29,45,0,3,24,8,24,5,True,True
1389,29,46,1,0,28,9,27,9,True,True
1390,29,47,3,0,28,10,25,10,True,True
1391,29,48,1,1,22,10,21,9,True,True
1392,30,1,1,0,4,0,3,0,True,False
1393,30,2,0,0,1,0,1,0,True,False
1394,30,3,0,0,1,1,1,1,True,True
1395,30,4,0,0,3,0,3,0,True,False
1396,30,5,0,0,1,5,1,5,True,True
1397,30,6,0,0,1,0,1,0,True,False
1398,30,7,0,0,0,0,0,0,False,False
1399,30,8,0,0,0,1,0,1,False,True
1400,30,9,0,0,0,0,0,0,False,False
1401,30,10,0,0,0,0,0,0,False,False
1402,30,11,0,0,0,2,0,2,False,True
1403,30,12,0,0,0,0,0,0,False,False
1404,30,13,0,0,0,0,0,0,False,False
1405,30,14,0,0,0,0,0,0,False,False
1406,30,15,0,0,0,0,0,0,False,False
1407,30,16,0,0,0,0,0,0,False,False
1408,30,17,0,0,0,0,0,0,False,False
1409,30,18,0,0,1,0,1,0,True,False
1410,30,19,0,0,0,0,0,0,False,False
1411,30,20,0,0,0,0,0,0,False,False
1412,30,21,0,0,1,0,1,0,True,False
1413,30,22,0,0,0,0,0,0,False,False
1414,30,23,0,0,0,0,0,0,False,False
1415,30,24,1,0,1,0,0,0,False,False
1416,30,25,0,0,0,1,0,1,False,True
1417,30,26,0,0,0,0,0,0,False,False
1418,30,27,0,0,1,0,1,0,True,False
1419,30,28,0,0,1,0,1,0,True,False
1420,30,29,0,0,2,1,2,1,True,True
1421,30,30,0,0,0,1,0,1,False,True
1422,30,31,0,0,0,0,0,0,False,False
1423,30,32,0,0,0,0,0,0,False,False
1424,30,33,0,0,1,0,1,0,True,False
1425,30,34,0,0,0,0,0,0,False,False
1426,30,35,0,0,0,0,0,0,False,False
1427,30,36,0,0,0,1,0,1,False,True
1428,30,37,0,0,0,0,0,0,False,False
1429,30,38,0,0,0,0,0,0,False,False
1430,30,39,0,1,1,1,1,0,True,False
1431,30,40,0,0,0,1,0,1,False,True
1432,30,41,0,0,0,3,0,3,False,True
1433,30,42,0,0,0,1,0,1,False,True
1434,30,43,0,0,1,0,1,0,True,False
1435,30,44,1,0,1,0,0,0,False,False
1436,30,45,0,0,0,0,0,0,False,False
1437,30,46,1,0,0,0,-1,0,False,False
1438,30,47,0,0,3,0,3,0,True,False
1439,30,48,0,0,0,1,0,1,False,True
1440,31,1,1,0,2,3,1,3,True,True
1441,31,2,1,0,8,2,7,2,True,True
1442,31,3,0,1,6,3,6,2,True,True
1443,31,4,0,0,4,4,4,4,True,True
1444,31,5,0,0,2,5,2,5,True,True
1445,31,6,0,0,2,4,2,4,True,True
1446,31,7,0,0,2,6,2,6,True,True
1447,31,8,0,0,2,8,2,8,True,True
1448,31,9,0,0,2,9,2,9,True,True
1449,31,10,0,0,2,8,2,8,True,True
1450,31,11,0,0,3,3,3,3,True,True
1451,31,12,0,0,6,2,6,2,True,True
1452,31,13,0,0,2,1,2,1,True,True
1453,31,14,1,1,2,1,1,0,True,False
1454,31,15,0,0,0,3,0,3,False,True
1455,31,16,0,0,2,2,2,2,True,True
1456,31,17,0,1,0,4,0,3,False,True
1457,31,18,0,0,4,5,4,5,True,True
1458,31,19,0,1,3,4,3,3,True,True
1459,31,20,1,1,13,5,12,4,True,True
1460,31,21,0,0,15,17,15,17,True,True
1461,31,22,0,0,15,19,15,19,True,True
1462,31,23,1,0,20,22,19,22,True,True
1463,31,24,1,1,15,13,14,12,True,True
1464,31,25,0,1,11,21,11,20,True,True
1465,31,26,0,0,13,15,13,15,True,True
1466,31,27,2,1,13,16,11,15,True,True
1467,31,28,0,2,14,23,14,21,True,True
1468,31,29,0,1,6,18,6,17,True,True
1469,31,30,0,0,6,14,6,14,True,True
1470,31,31,1,1,11,9,10,8,True,True
1471,31,32,1,1,3,3,2,2,True,True
1472,31,33,1,1,1,6,0,5,False,True
1473,31,34,2,1,4,6,2,5,True,True
1474,31,35,3,5,2,5,-1,0,False,False
1475,31,36,2,8,3,8,1,0,True,False
1476,31,37,0,1,2,16,2,15,True,True
1477,31,38,0,1,4,10,4,9,True,True
1478,31,39,0,1,7,4,7,3,True,True
1479,31,40,0,0,7,2,7,2,True,True
1480,31,41,0,0,14,2,14,2,True,True
1481,31,42,0,0,1,3,1,3,True,True
1482,31,43,0,0,6,2,6,2,True,True
1483,31,44,0,0,5,2,5,2,True,True
1484,31,45,0,0,0,2,0,2,False,True
1485,31,46,0,0,6,3,6,3,True,True
1486,31,47,1,0,5,4,4,4,True,True
1487,31,48,0,1,1,3,1,2,True,True
1488,32,1,0,0,20,13,20,13,True,True
1489,32,2,2,1,29,14,27,13,True,True
1490,32,3,3,1,22,15,19,14,True,True
1491,32,4,2,0,17,17,15,17,True,True
1492,32,5,1,1,14,17,13,16,True,True
1493,32,6,0,0,12,14,12,14,True,True
1494,32,7,1,1,16,22,15,21,True,True
1495,32,8,0,2,14,22,14,20,True,True
1496,32,9,0,1,11,22,11,21,True,True
1497,32,10,0,2,10,15,10,13,True,True
1498,32,11,0,0,6,18,6,18,True,True
1499,32,12,1,1,9,10,8,9,True,True
1500,32,13,0,0,7,11,7,11,True,True
1501,32,14,0,0,3,5,3,5,True,True
1502,32,15,0,0,6,3,6,3,True,True
1503,32,16,0,0,10,5,10,5,True,True
1504,32,17,0,0,5,3,5,3,True,True
1505,32,18,1,0,8,2,7,2,True,True
1506,32,19,0,1,4,1,4,0,True,False
1507,32,20,0,0,3,1,3,1,True,True
1508,32,21,0,0,4,2,4,2,True,True
1509,32,22,0,1,8,5,8,4,True,True
1510,32,23,1,0,6,2,5,2,True,True
1511,32,24,0,0,4,3,4,3,True,True
1512,32,25,1,0,9,2,8,2,True,True
1513,32,26,0,0,6,0,6,0,True,False
1514,32,27,1,0,5,5,4,5,True,True
1515,32,28,0,0,6,2,6,2,True,True
1516,32,29,0,0,4,2,4,2,True,True
1517,32,30,0,0,9,3,9,3,True,True
1518,32,31,0,0,5,0,5,0,True,False
1519,32,32,1,0,5,2,4,2,True,True
1520,32,33,0,0,6,6,6,6,True,True
1521,32,34,1,0,4,3,3,3,True,True
1522,32,35,0,0,9,2,9,2,True,True
1523,32,36,0,0,3,3,3,3,True,True
1524,32,37,1,0,7,12,6,12,True,True
1525,32,38,1,0,7,3,6,3,True,True
1526,32,39,0,0,5,5,5,5,True,True
1527,32,40,0,1,12,3,12,2,True,True
1528,32,41,0,0,10,5,10,5,True,True
1529,32,42,1,0,13,2,12,2,True,True
1530,32,43,0,0,14,6,14,6,True,True
1531,32,44,0,1,13,5,13,4,True,True
1532,32,45,1,1,18,7,17,6,True,True
1533,32,46,1,0,18,6,17,6,True,True
1534,32,47,1,0,27,7,26,7,True,True
1535,32,48,0,0,20,9,20,9,True,True
1536,33,1,344,401,1256,611,912,210,True,True
1537,33,2,271,373,1017,759,746,386,True,True
1538,33,3,152,274,767,784,615,510,True,True
1539,33,4,123,232,519,733,396,501,True,True
1540,33,5,83,217,384,662,301,445,True,True
1541,33,6,60,161,260,582,200,421,True,True
1542,33,7,59,95,189,489,130,394,True,True
1543,33,8,37,90,133,401,96,311,True,True
1544,33,9,48,69,125,291,77,222,True,True
1545,33,10,92,41,90,202,-2,161,False,True
1546,33,11,103,40,57,119,-46,79,False,True
1547,33,12,159,36,89,77,-70,41,False,True
1548,33,13,379,47,128,60,-251,13,False,True
1549,33,14,697,66,167,64,-530,-2,False,False
1550,33,15,929,80,199,62,-730,-18,False,False
1551,33,16,963,95,268,81,-695,-14,False,False
1552,33,17,824,142,426,84,-398,-58,False,False
1553,33,18,675,176,463,104,-212,-72,False,False
1554,33,19,540,204,383,143,-157,-61,False,False
1555,33,20,474,218,338,179,-136,-39,False,False
1556,33,21,382,213,319,170,-63,-43,False,False
1557,33,22,329,223,321,217,-8,-6,False,False
1558,33,23,293,248,311,204,18,-44,True,False
1559,33,24,298,267,319,224,21,-43,True,False
1560,33,25,317,240,358,229,41,-11,True,False
1561,33,26,291,294,336,259,45,-35,True,False
1562,33,27,256,289,319,274,63,-15,True,False
1563,33,28,265,280,345,268,80,-12,True,False
1564,33,29,259,279,343,278,84,-1,True,False
1565,33,30,254,258,357,276,103,18,True,True
1566,33,31,256,288,402,280,146,-8,True,False
1567,33,32,263,228,355,275,92,47,True,True
1568,33,33,240,244,328,270,88,26,True,True
1569,33,34,260,242,332,249,72,7,True,True
1570,33,35,272,308,327,269,55,-39,True,False
1571,33,36,396,329,452,301,56,-28,True,False
1572,33,37,399,354,572,371,173,17,True,True
1573,33,38,510,318,752,328,242,10,True,True
1574,33,39,544,298,932,396,388,98,True,True
1575,33,40,550,307,1010,363,460,56,True,True
1576,33,41,534,324,1099,391,565,67,True,True
1577,33,42,574,261,1318,341,744,80,True,True
1578,33,43,659,276,1510,397,851,121,True,True
1579,33,44,630,299,1695,436,1065,137,True,True
1580,33,45,655,322,1782,450,1127,128,True,True
1581,33,46,629,337,1752,494,1123,157,True,True
1582,33,47,585,324,1491,513,906,189,True,True
1583,33,48,534,312,1505,538,971,226,True,True
1584,34,1,5,7,35,18,30,11,True,True
1585,34,2,3,9,31,30,28,21,True,True
1586,34,3,5,4,30,21,25,17,True,True
1587,34,4,3,4,21,26,18,22,True,True
1588,34,5,4,7,15,19,11,12,True,True
1589,34,6,3,3,19,18,16,15,True,True
1590,34,7,4,2,12,17,8,15,True,True
1591,34,8,1,2,12,15,11,13,True,True
1592,34,9,1,1,8,12,7,11,True,True
1593,34,10,0,1,8,9,8,8,True,True
1594,34,11,0,1,6,4,6,3,True,True
1595,34,12,1,0,11,6,10,6,True,True
1596,34,13,0,1,20,5,20,4,True,True
1597,34,14,2,0,24,6,22,6,True,True
1598,34,15,0,0,26,5,26,5,True,True
1599,34,16,2,0,51,11,49,11,True,True
1600,34,17,5,0,49,6,44,6,True,True
1601,34,18,4,1,38,6,34,5,True,True
1602,34,19,1,2,43,6,42,4,True,True
1603,34,20,2,0,40,8,38,8,True,True
1604,34,21,5,5,54,11,49,6,True,True
1605,34,22,1,1,37,10,36,9,True,True
1606,34,23,2,1,41,9,39,8,True,True
1607,34,24,6,4,29,14,23,10,True,True
1608,34,25,4,2,34,7,30,5,True,True
1609,34,26,8,2,41,10,33,8,True,True
1610,34,27,5,2,50,8,45,6,True,True
1611,34,28,3,5,48,18,45,13,True,True
1612,34,29,1,5,38,14,37,9,True,True
1613,34,30,1,4,26,8,25,4,True,True
1614,34,31,5,1,23,12,18,11,True,True
1615,34,32,4,3,34,10,30,7,True,True
1616,34,33,3,2,23,7,20,5,True,True
1617,34,34,4,2,16,5,12,3,True,True
1618,34,35,3,1,19,14,16,13,True,True
1619,34,36,14,5,29,15,15,10,True,True
1620,34,37,12,3,37,18,25,15,True,True
1621,34,38,6,7,28,36,22,29,True,True
1622,34,39,9,8,32,27,23,19,True,True
1623,34,40,9,3,33,10,24,7,True,True
1624,34,41,15,4,40,10,25,6,True,True
1625,34,42,12,3,41,19,29,16,True,True
1626,34,43,7,4,26,16,19,12,True,True
1627,34,44,5,3,34,18,29,15,True,True
1628,34,45,2,9,31,9,29,0,True,False
1629,34,46,7,5,27,19,20,14,True,True
1630,34,47,6,12,45,16,39,4,True,True
1631,34,48,11,5,53,16,42,11,True,True
1632,35,1,1,1,40,17,39,16,True,True
1633,35,2,1,0,35,16,34,16,True,True
1634,35,3,0,0,36,16,36,16,True,True
1635,35,4,0,0,22,22,22,22,True,True
1636,35,5,1,2,33,26,32,24,True,True
1637,35,6,2,1,20,18,18,17,True,True
1638,35,7,0,2,11,26,11,24,True,True
1639,35,8,2,3,10,27,8,24,True,True
1640,35,9,1,1,9,29,8,28,True,True
1641,35,10,0,1,16,27,16,26,True,True
1642,35,11,2,1,9,14,7,13,True,True
1643,35,12,1,3,5,21,4,18,True,True
1644,35,13,2,0,9,14,7,14,True,True
1645,35,14,1,0,12,5,11,5,True,True
1646,35,15,4,0,11,5,7,5,True,True
1647,35,16,3,1,15,3,12,2,True,True
1648,35,17,2,0,15,7,13,7,True,True
1649,35,18,2,0,5,7,3,7,True,True
1650,35,19,3,0,7,6,4,6,True,True
1651,35,20,2,0,11,3,9,3,True,True
1652,35,21,2,0,11,4,9,4,True,True
1653,35,22,3,0,12,3,9,3,True,True
1654,35,23,3,0,9,4,6,4,True,True
1655,35,24,4,0,11,8,7,8,True,True
1656,35,25,4,0,16,1,12,1,True,True
1657,35,26,0,0,11,10,11,10,True,True
1658,35,27,2,0,9,3,7,3,True,True
1659,35,28,2,0,5,3,3,3,True,True
1660,35,29,2,1,11,1,9,0,True,False
1661,35,30,3,0,8,6,5,6,True,True
1662,35,31,1,0,8,4,7,4,True,True
1663,35,32,0,0,9,5,9,5,True,True
1664,35,33,0,0,10,7,10,7,True,True
1665,35,34,0,0,11,10,11,10,True,True
1666,35,35,0,0,12,5,12,5,True,True
1667,35,36,1,0,7,6,6,6,True,True
1668,35,37,1,1,12,8,11,7,True,True
1669,35,38,0,0,10,8,10,8,True,True
1670,35,39,0,1,19,7,19,6,True,True
1671,35,40,0,0,15,11,15,11,True,True
1672,35,41,2,1,22,4,20,3,True,True
1673,35,42,3,0,16,6,13,6,True,True
1674,35,43,3,0,22,13,19,13,True,True
1675,35,44,2,0,26,12,24,12,True,True
1676,35,45,2,0,28,9,26,9,True,True
1677,35,46,0,1,26,11,26,10,True,True
1678,35,47,3,0,29,17,26,17,True,True
1679,35,48,2,0,23,17,21,17,True,True
1680,36,1,88,107,560,308,472,201,True,True
1681,36,2,87,158,634,391,547,233,True,True
1682,36,3,84,171,694,452,610,281,True,True
1683,36,4,80,191,578,494,498,303,True,True
1684,36,5,52,197,542,608,490,411,True,True
1685,36,6,48,181,452,548,404,367,True,True
1686,36,7,27,177,380,568,353,391,True,True
1687,36,8,27,131,354,487,327,356,True,True
1688,36,9,33,142,348,543,315,401,True,True
1689,36,10,15,75,273,418,258,343,True,True
1690,36,11,12,47,124,267,112,220,True,True
1691,36,12,6,19,101,142,95,123,True,True
1692,36,13,2,10,59,87,57,77,True,True
1693,36,14,1,3,42,61,41,58,True,True
1694,36,15,3,3,46,38,43,35,True,True
1695,36,16,4,2,39,32,35,30,True,True
1696,36,17,5,4,38,32,33,28,True,True
1697,36,18,2,3,39,32,37,29,True,True
1698,36,19,3,2,33,25,30,23,True,True
1699,36,20,3,3,38,30,35,27,True,True
1700,36,21,1,1,40,26,39,25,True,True
1701,36,22,3,6,45,42,42,36,True,True
1702,36,23,1,6,26,36,25,30,True,True
1703,36,24,4,0,44,31,40,31,True,True
1704,36,25,2,3,41,39,39,36,True,True
1705,36,26,4,4,44,30,40,26,True,True
1706,36,27,9,3,45,49,36,46,True,True
1707,36,28,1,3,45,33,44,30,True,True
1708,36,29,2,11,51,54,49,43,True,True
1709,36,30,3,6,52,60,49,54,True,True
1710,36,31,3,11,43,47,40,36,True,True
1711,36,32,7,8,50,55,43,47,True,True
1712,36,33,5,4,48,40,43,36,True,True
1713,36,34,0,6,38,45,38,39,True,True
1714,36,35,4,3,54,41,50,38,True,True
1715,36,36,3,7,59,64,56,57,True,True
1716,36,37,5,9,73,76,68,67,True,True
1717,36,38,4,8,98,84,94,76,True,True
1718,36,39,8,15,101,84,93,69,True,True
1719,36,40,13,9,139,88,126,79,True,True
1720,36,41,10,22,161,98,151,76,True,True
1721,36,42,13,24,184,103,171,79,True,True
1722,36,43,21,16,192,105,171,89,True,True
1723,36,44,22,22,244,113,222,91,True,True
1724,36,45,49,32,285,131,236,99,True,True
1725,36,46,39,47,328,160,289,113,True,True
1726,36,47,65,54,432,202,367,148,True,True
1727,36,48,73,62,497,209,424,147,True,True
1728,37,1,257,306,1039,608,782,302,True,True
1729,37,2,255,396,1125,742,870,346,True,True
1730,37,3,235,458,1109,907,874,449,True,True
1731,37,4,226,488,941,914,715,426,True,True
1732,37,5,175,498,848,934,673,436,True,True
1733,37,6,110,488,742,962,632,474,True,True
1734,37,7,96,449,663,899,567,450,True,True
1735,37,8,100,377,577,810,477,433,True,True
1736,37,9,84,367,539,864,455,497,True,True
1737,37,10,44,226,401,676,357,450,True,True
1738,37,11,26,125,215,436,189,311,True,True
1739,37,12,15,82,130,249,115,167,True,True
1740,37,13,9,63,104,171,95,108,True,True
1741,37,14,9,38,73,101,64,63,True,True
1742,37,15,8,18,59,55,51,37,True,True
1743,37,16,11,17,49,44,38,27,True,True
1744,37,17,7,19,53,53,46,34,True,True
1745,37,18,7,12,66,42,59,30,True,True
1746,37,19,16,6,71,52,55,46,True,True
1747,37,20,10,10,74,46,64,36,True,True
1748,37,21,10,7,67,40,57,33,True,True
1749,37,22,7,14,55,70,48,56,True,True
1750,37,23,1,17,65,58,64,41,True,True
1751,37,24,3,21,64,63,61,42,True,True
1752,37,25,8,16,63,49,55,33,True,True
1753,37,26,5,15,65,57,60,42,True,True
1754,37,27,9,12,76,70,67,58,True,True
1755,37,28,9,18,94,77,85,59,True,True
1756,37,29,5,29,84,91,79,62,True,True
1757,37,30,3,18,98,95,95,77,True,True
1758,37,31,12,20,85,110,73,90,True,True
1759,37,32,10,16,93,110,83,94,True,True
1760,37,33,4,18,90,103,86,85,True,True
1761,37,34,7,25,96,119,89,94,True,True
1762,37,35,11,16,92,116,81,100,True,True
1763,37,36,13,31,104,134,91,103,True,True
1764,37,37,20,32,143,167,123,135,True,True
1765,37,38,28,39,190,159,162,120,True,True
1766,37,39,30,44,228,178,198,134,True,True
1767,37,40,35,43,248,182,213,139,True,True
1768,37,41,57,52,304,204,247,152,True,True
1769,37,42,52,66,335,221,283,155,True,True
1770,37,43,73,88,440,242,367,154,True,True
1771,37,44,103,115,510,251,407,136,True,True
1772,37,45,148,112,552,310,404,198,True,True
1773,37,46,166,145,678,382,512,237,True,True
1774,37,47,169,176,814,423,645,247,True,True
1775,37,48,224,210,941,539,717,329,True,True
1776,38,1,1,0,14,3,13,3,True,True
1777,38,2,0,0,15,4,15,4,True,True
1778,38,3,0,0,12,7,12,7,True,True
1779,38,4,0,0,5,1,5,1,True,True
1780,38,5,0,0,6,3,6,3,True,True
1781,38,6,1,0,7,1,6,1,True,True
1782,38,7,2,0,3,5,1,5,True,True
1783,38,8,0,0,2,0,2,0,True,False
1784,38,9,0,1,0,5,0,4,False,True
1785,38,10,0,1,2,1,2,0,True,False
1786,38,11,1,0,0,3,-1,3,False,True
1787,38,12,0,0,10,1,10,1,True,True
1788,38,13,1,0,8,0,7,0,True,False
1789,38,14,1,0,14,5,13,5,True,True
1790,38,15,3,0,11,4,8,4,True,True
1791,38,16,2,0,11,3,9,3,True,True
1792,38,17,1,1,13,4,12,3,True,True
1793,38,18,2,0,18,4,16,4,True,True
1794,38,19,0,0,20,9,20,9,True,True
1795,38,20,0,0,14,3,14,3,True,True
1796,38,21,0,0,8,5,8,5,True,True
1797,38,22,2,0,17,0,15,0,True,False
1798,38,23,1,0,9,4,8,4,True,True
1799,38,24,2,0,11,5,9,5,True,True
1800,38,25,3,0,20,6,17,6,True,True
1801,38,26,0,0,19,6,19,6,True,True
1802,38,27,0,0,13,1,13,1,True,True
1803,38,28,4,0,11,5,7,5,True,True
1804,38,29,3,0,16,6,13,6,True,True
1805,38,30,1,0,15,5,14,5,True,True
1806,38,31,2,1,13,7,11,6,True,True
1807,38,32,2,1,14,9,12,8,True,True
1808,38,33,1,0,16,7,15,7,True,True
1809,38,34,0,2,16,6,16,4,True,True
1810,38,35,1,0,15,6,14,6,True,True
1811,38,36,0,1,19,7,19,6,True,True
1812,38,37,0,0,11,1,11,1,True,True
1813,38,38,4,1,11,5,7,4,True,True
1814,38,39,1,0,14,4,13,4,True,True
1815,38,40,0,0,9,6,9,6,True,True
1816,38,41,0,0,18,9,18,9,True,True
1817,38,42,0,0,25,0,25,0,True,False
1818,38,43,0,0,15,2,15,2,True,True
1819,38,44,0,0,18,1,18,1,True,True
1820,38,45,2,0,16,7,14,7,True,True
1821,38,46,1,1,21,5,20,4,True,True
1822,38,47,3,0,17,2,14,2,True,True
1823,38,48,1,0,13,6,12,6,True,True
1824,39,1,2,0,48,15,46,15,True,True
1825,39,2,4,3,54,23,50,20,True,True
1826,39,3,2,3,59,24,57,21,True,True
1827,39,4,2,3,44,28,42,25,True,True
1828,39,5,2,1,38,23,36,22,True,True
1829,39,6,1,1,26,14,25,13,True,True
1830,39,7,1,4,14,22,13,18,True,True
1831,39,8,1,1,15,22,14,21,True,True
1832,39,9,1,1,17,21,16,20,True,True
1833,39,10,0,2,15,31,15,29,True,True
1834,39,11,1,1,10,14,9,13,True,True
1835,39,12,0,2,10,17,10,15,True,True
1836,39,13,1,6,14,15,13,9,True,True
1837,39,14,1,4,16,17,15,13,True,True
1838,39,15,4,0,22,2,18,2,True,True
1839,39,16,1,0,20,8,19,8,True,True
1840,39,17,1,1,14,7,13,6,True,True
1841,39,18,1,0,14,1,13,1,True,True
1842,39,19,0,1,13,12,13,11,True,True
1843,39,20,0,2,17,13,17,11,True,True
1844,39,21,1,1,12,11,11,10,True,True
1845,39,22,1,0,12,5,11,5,True,True
1846,39,23,2,0,16,6,14,6,True,True
1847,39,24,4,0,15,7,11,7,True,True
1848,39,25,2,0,20,3,18,3,True,True
1849,39,26,1,0,8,11,7,11,True,True
1850,39,27,1,1,10,10,9,9,True,True
1851,39,28,1,0,13,3,12,3,True,True
1852,39,29,2,0,14,17,12,17,True,True
1853,39,30,0,0,15,12,15,12,True,True
1854,39,31,0,0,15,7,15,7,True,True
1855,39,32,1,0,23,14,22,14,True,True
1856,39,33,0,1,27,7,27,6,True,True
1857,39,34,0,1,30,11,30,10,True,True
1858,39,35,1,3,17,9,16,6,True,True
1859,39,36,1,0,8,10,7,10,True,True
1860,39,37,1,0,17,10,16,10,True,True
1861,39,38,0,0,22,15,22,15,True,True
1862,39,39,0,1,24,8,24,7,True,True
1863,39,40,0,0,29,11,29,11,True,True
1864,39,41,1,0,45,16,44,16,True,True
1865,39,42,0,0,42,14,42,14,True,True
1866,39,43,2,1,33,13,31,12,True,True
1867,39,44,1,2,28,21,27,19,True,True
1868,39,45,0,0,33,21,33,21,True,True
1869,39,46,0,0,33,12,33,12,True,True
1870,39,47,0,4,44,19,44,15,True,True
1871,39,48,4,3,45,23,41,20,True,True
1872,40,1,287,389,668,316,381,-73,True,False
1873,40,2,225,391,489,380,264,-11,True,False
1874,40,3,172,297,427,371,255,74,True,True
1875,40,4,157,289,304,399,147,110,True,True
1876,40,5,115,236,226,326,111,90,True,True
1877,40,6,78,210,166,288,88,78,True,True
1878,40,7,45,130,126,222,81,92,True,True
1879,40,8,48,100,92,209,44,109,True,True
1880,40,9,44,85,83,156,39,71,True,True
1881,40,10,46,45,39,111,-7,66,False,True
1882,40,11,58,44,28,73,-30,29,False,True
1883,40,12,93,22,34,29,-59,7,False,True
1884,40,13,175,33,24,37,-151,4,False,True
1885,40,14,244,43,33,26,-211,-17,False,False
1886,40,15,351,41,48,31,-303,-10,False,False
1887,40,16,486,72,46,25,-440,-47,False,False
1888,40,17,511,73,103,30,-408,-43,False,False
1889,40,18,572,86,87,37,-485,-49,False,False
1890,40,19,525,105,81,27,-444,-78,False,False
1891,40,20,360,143,61,52,-299,-91,False,False
1892,40,21,246,133,73,73,-173,-60,False,False
1893,40,22,151,125,74,62,-77,-63,False,False
1894,40,23,139,112,77,80,-62,-32,False,False
1895,40,24,119,101,88,79,-31,-22,False,False
1896,40,25,113,107,79,72,-34,-35,False,False
1897,40,26,85,121,74,91,-11,-30,False,False
1898,40,27,76,105,74,108,-2,3,False,True
1899,40,28,90,117,108,90,18,-27,True,False
1900,40,29,80,117,118,82,38,-35,True,False
1901,40,30,87,108,108,88,21,-20,True,False
1902,40,31,98,104,135,82,37,-22,True,False
1903,40,32,106,102,100,126,-6,24,False,True
1904,40,33,69,90,155,117,86,27,True,True
1905,40,34,108,111,98,126,-10,15,False,True
1906,40,35,114,121,129,136,15,15,True,True
1907,40,36,124,132,185,166,61,34,True,True
1908,40,37,185,150,251,178,66,28,True,True
1909,40,38,198,160,308,191,110,31,True,True
1910,40,39,210,176,404,201,194,25,True,True
1911,40,40,219,166,435,178,216,12,True,True
1912,40,41,244,203,466,156,222,-47,True,False
1913,40,42,243,191,554,175,311,-16,True,False
1914,40,43,275,186,596,188,321,2,True,True
1915,40,44,307,216,685,182,378,-34,True,False
1916,40,45,374,234,608,232,234,-2,True,False
1917,40,46,388,255,691,227,303,-28,True,False
1918,40,47,437,248,730,240,293,-8,True,False
1919,40,48,366,293,751,311,385,18,True,True
1920,41,1,622,550,1513,829,891,279,True,True
1921,41,2,509,517,1256,988,747,471,True,True
1922,41,3,367,483,1003,979,636,496,True,True
1923,41,4,277,408,767,878,490,470,True,True
1924,41,5,269,397,693,891,424,494,True,True
1925,41,6,159,341,518,849,359,508,True,True
1926,41,7,127,269,429,784,302,515,True,True
1927,41,8,126,240,414,696,288,456,True,True
1928,41,9,120,217,347,585,227,368,True,True
1929,41,10,152,167,298,503,146,336,True,True
1930,41,11,184,140,195,288,11,148,True,True
1931,41,12,287,102,183,191,-104,89,False,True
1932,41,13,350,152,182,155,-168,3,False,True
1933,41,14,761,169,328,113,-433,-56,False,False
1934,41,15,792,197,437,160,-355,-37,False,False
1935,41,16,1054,268,627,244,-427,-24,False,False
1936,41,17,1183,315,604,274,-579,-41,False,False
1937,41,18,967,347,559,293,-408,-54,False,False
1938,41,19,678,403,527,369,-151,-34,False,False
1939,41,20,563,490,474,453,-89,-37,False,False
1940,41,21,441,456,543,515,102,59,True,True
1941,41,22,430,501,524,607,94,106,True,True
1942,41,23,467,445,578,566,111,121,True,True
1943,41,24,516,504,665,517,149,13,True,True
1944,41,25,452,460,697,509,245,49,True,True
1945,41,26,511,468,759,517,248,49,True,True
1946,41,27,525,442,745,556,220,114,True,True
1947,41,28,513,471,702,557,189,86,True,True
1948,41,29,509,400,667,535,158,135,True,True
1949,41,30,542,407,753,491,211,84,True,True
1950,41,31,483,389,787,496,304,107,True,True
1951,41,32,457,369,861,498,404,129,True,True
1952,41,33,385,336,836,504,451,168,True,True
1953,41,34,438,326,774,511,336,185,True,True
1954,41,35,662,395,901,489,239,94,True,True
1955,41,36,872,441,1224,561,352,120,True,True
1956,41,37,835,425,1367,637,532,212,True,True
1957,41,38,852,409,1489,687,637,278,True,True
1958,41,39,735,386,1563,681,828,295,True,True
1959,41,40,696,384,1598,649,902,265,True,True
1960,41,41,668,326,1621,636,953,310,True,True
1961,41,42,705,355,1597,619,892,264,True,True
1962,41,43,823,406,1811,658,988,252,True,True
1963,41,44,860,416,1807,651,947,235,True,True
1964,41,45,821,467,1824,722,1003,255,True,True
1965,41,46,868,455,1832,681,964,226,True,True
1966,41,47,741,466,1818,794,1077,328,True,True
1967,41,48,708,475,1727,827,1019,352,True,True
1968,42,1,194,145,1252,637,1058,492,True,True
1969,42,2,141,173,1105,740,964,567,True,True
1970,42,3,146,169,1004,813,858,644,True,True
1971,42,4,111,149,827,780,716,631,True,True
1972,42,5,96,111,695,751,599,640,True,True
1973,42,6,72,127,578,740,506,613,True,True
1974,42,7,74,114,439,692,365,578,True,True
1975,42,8,67,97,386,632,319,535,True,True
1976,42,9,83,119,337,749,254,630,True,True
1977,42,10,70,98,342,616,272,518,True,True
1978,42,11,86,72,202,364,116,292,True,True
1979,42,12,135,57,170,207,35,150,True,True
1980,42,13,229,61,145,150,-84,89,False,True
1981,42,14,269,93,201,139,-68,46,False,True
1982,42,15,391,71,294,106,-97,35,False,True
1983,42,16,409,93,327,144,-82,51,False,True
1984,42,17,329,99,313,174,-16,75,False,True
1985,42,18,308,125,308,232,0,107,False,True
1986,42,19,173,106,235,269,62,163,True,True
1987,42,20,127,128,232,292,105,164,True,True
1988,42,21,82,122,251,304,169,182,True,True
1989,42,22,88,181,282,363,194,182,True,True
1990,42,23,98,136,256,283,158,147,True,True
1991,42,24,112,149,337,268,225,119,True,True
1992,42,25,109,138,338,247,229,109,True,True
1993,42,26,103,97,369,242,266,145,True,True
1994,42,27,103,119,399,249,296,130,True,True
1995,42,28,104,135,371,271,267,136,True,True
1996,42,29,106,96,403,226,297,130,True,True
1997,42,30,136,110,391,263,255,153,True,True
1998,42,31,117,93,414,270,297,177,True,True
1999,42,32,97,84,419,288,322,204,True,True
2000,42,33,75,86,458,291,383,205,True,True
2001,42,34,138,86,454,274,316,188,True,True
2002,42,35,247,130,451,282,204,152,True,True
2003,42,36,299,137,619,327,320,190,True,True
2004,42,37,258,127,665,314,407,187,True,True
2005,42,38,233,115,766,353,533,238,True,True
2006,42,39,170,92,816,360,646,268,True,True
2007,42,40,162,100,836,397,674,297,True,True
2008,42,41,142,83,844,359,702,276,True,True
2009,42,42,183,103,885,398,702,295,True,True
2010,42,43,203,93,1070,393,867,300,True,True
2011,42,44,177,129,1160,483,983,354,True,True
2012,42,45,213,129,1242,495,1029,366,True,True
2013,42,46,188,137,1270,507,1082,370,True,True
2014,42,47,196,126,1202,532,1006,406,True,True
2015,42,48,215,148,1271,598,1056,450,True,True
2016,43,1,943,655,1225,724,282,69,True,True
2017,43,2,753,509,932,738,179,229,True,True
2018,43,3,450,458,719,632,269,174,True,True
2019,43,4,346,338,494,529,148,191,True,True
2020,43,5,228,252,353,451,125,199,True,True
2021,43,6,157,205,281,436,124,231,True,True
2022,43,7,152,165,191,419,39,254,True,True
2023,43,8,119,142,153,330,34,188,True,True
2024,43,9,104,140,142,320,38,180,True,True
2025,43,10,190,126,140,221,-50,95,False,True
2026,43,11,255,108,188,162,-67,54,False,True
2027,43,12,489,135,408,162,-81,27,False,True
2028,43,13,742,172,560,210,-182,38,False,True
2029,43,14,1446,229,906,346,-540,117,False,True
2030,43,15,2110,310,1423,558,-687,248,False,True
2031,43,16,3103,458,2275,880,-828,422,False,True
2032,43,17,3770,459,2908,772,-862,313,False,True
2033,43,18,4213,729,3462,1012,-751,283,False,True
2034,43,19,4141,871,3382,1126,-759,255,False,True
2035,43,20,3993,1076,3972,1573,-21,497,False,True
2036,43,21,3367,1139,3975,1824,608,685,True,True
2037,43,22,3401,1322,4003,1919,602,597,True,True
2038,43,23,3382,1429,4111,1964,729,535,True,True
2039,43,24,4146,1683,4394,1898,248,215,True,True
2040,43,25,4907,2040,4753,2102,-154,62,False,True
2041,43,26,5169,2343,4934,2209,-235,-134,False,False
2042,43,27,4857,2380,4381,2116,-476,-264,False,False
2043,43,28,5047,2340,4115,2067,-932,-273,False,False
2044,43,29,4872,2335,3957,1971,-915,-364,False,False
2045,43,30,4618,2396,4065,1976,-553,-420,False,False
2046,43,31,4599,2360,3989,1845,-610,-515,False,False
2047,43,32,3936,2275,3615,1737,-321,-538,False,False
2048,43,33,3418,2097,3125,1538,-293,-559,False,False
2049,43,34,2746,1842,2611,1395,-135,-447,False,False
2050,43,35,3207,1947,2729,1214,-478,-733,False,False
2051,43,36,4468,2441,3508,1414,-960,-1027,False,False
2052,43,37,4546,2187,3982,1378,-564,-809,False,False
2053,43,38,4597,2074,4361,1304,-236,-770,False,False
2054,43,39,4676,1959,3754,1263,-922,-696,False,False
2055,43,40,4284,1902,3389,1113,-895,-789,False,False
2056,43,41,4325,1724,2897,1220,-1428,-504,False,False
2057,43,42,4588,1680,2707,943,-1881,-737,False,False
2058,43,43,4328,1463,2914,973,-1414,-490,False,False
2059,43,44,4073,1169,2942,1087,-1131,-82,False,False
2060,43,45,3662,1215,2689,962,-973,-253,False,False
2061,43,46,2306,857,2196,880,-110,23,False,True
2062,43,47,1827,723,1856,778,29,55,True,True
2063,43,48,1277,531,1625,670,348,139,True,True
2064,44,1,0,0,5,1,5,1,True,True
2065,44,2,0,0,5,2,5,2,True,True
2066,44,3,0,0,3,1,3,1,True,True
2067,44,4,0,0,4,0,4,0,True,False
2068,44,5,0,1,1,2,1,1,True,True
2069,44,6,0,0,1,2,1,2,True,True
2070,44,7,0,0,1,1,1,1,True,True
2071,44,8,0,0,1,1,1,1,True,True
2072,44,9,0,0,0,0,0,0,False,False
2073,44,10,0,0,0,0,0,0,False,False
2074,44,11,0,0,0,1,0,1,False,True
2075,44,12,0,0,0,0,0,0,False,False
2076,44,13,0,0,1,0,1,0,True,False
2077,44,14,0,0,0,0,0,0,False,False
2078,44,15,0,0,0,0,0,0,False,False
2079,44,16,0,0,0,0,0,0,False,False
2080,44,17,0,0,1,0,1,0,True,False
2081,44,18,0,0,1,0,1,0,True,False
2082,44,19,0,0,1,0,1,0,True,False
2083,44,20,0,0,0,0,0,0,False,False
2084,44,21,0,0,0,0,0,0,False,False
2085,44,22,0,0,0,1,0,1,False,True
2086,44,23,0,0,0,0,0,0,False,False
2087,44,24,0,0,1,0,1,0,True,False
2088,44,25,0,0,0,0,0,0,False,False
2089,44,26,0,0,0,0,0,0,False,False
2090,44,27,0,0,0,0,0,0,False,False
2091,44,28,0,0,0,0,0,0,False,False
2092,44,29,0,0,0,0,0,0,False,False
2093,44,30,0,0,0,0,0,0,False,False
2094,44,31,0,0,0,0,0,0,False,False
2095,44,32,0,0,0,0,0,0,False,False
2096,44,33,0,0,0,1,0,1,False,True
2097,44,34,0,0,0,0,0,0,False,False
2098,44,35,0,0,0,0,0,0,False,False
2099,44,36,0,0,0,0,0,0,False,False
2100,44,37,0,0,1,1,1,1,True,True
2101,44,38,0,0,0,0,0,0,False,False
2102,44,39,0,0,1,0,1,0,True,False
2103,44,40,1,0,3,0,2,0,True,False
2104,44,41,0,0,2,0,2,0,True,False
2105,44,42,0,0,1,1,1,1,True,True
2106,44,43,0,0,1,0,1,0,True,False
2107,44,44,0,0,4,0,4,0,True,False
2108,44,45,0,0,0,0,0,0,False,False
2109,44,46,0,0,3,0,3,0,True,False
2110,44,47,0,0,2,0,2,0,True,False
2111,44,48,0,0,2,0,2,0,True,False
2112,45,1,419,289,570,405,151,116,True,True
2113,45,2,419,329,527,417,108,88,True,True
2114,45,3,450,371,433,461,-17,90,False,True
2115,45,4,408,375,373,501,-35,126,False,True
2116,45,5,398,449,301,483,-97,34,False,True
2117,45,6,357,529,220,446,-137,-83,False,False
2118,45,7,232,500,207,376,-25,-124,False,False
2119,45,8,187,464,169,367,-18,-97,False,False
2120,45,9,146,399,119,309,-27,-90,False,False
2121,45,10,88,263,118,166,30,-97,True,False
2122,45,11,70,125,73,120,3,-5,True,False
2123,45,12,59,82,80,90,21,8,True,True
2124,45,13,102,45,100,66,-2,21,False,True
2125,45,14,185,68,160,81,-25,13,False,True
2126,45,15,207,56,268,115,61,59,True,True
2127,45,16,263,56,442,126,179,70,True,True
2128,45,17,330,68,550,119,220,51,True,True
2129,45,18,398,66,781,152,383,86,True,True
2130,45,19,438,128,966,231,528,103,True,True
2131,45,20,453,140,883,284,430,144,True,True
2132,45,21,419,150,721,270,302,120,True,True
2133,45,22,459,194,597,334,138,140,True,True
2134,45,23,481,207,540,397,59,190,True,True
2135,45,24,525,236,559,357,34,121,True,True
2136,45,25,513,302,580,406,67,104,True,True
2137,45,26,550,299,568,442,18,143,True,True
2138,45,27,547,289,548,396,1,107,True,True
2139,45,28,540,315,642,398,102,83,True,True
2140,45,29,471,366,585,378,114,12,True,True
2141,45,30,508,322,519,334,11,12,True,True
2142,45,31,542,321,488,306,-54,-15,False,False
2143,45,32,513,273,393,242,-120,-31,False,False
2144,45,33,492,253,328,267,-164,14,False,True
2145,45,34,643,259,273,229,-370,-30,False,False
2146,45,35,729,322,320,244,-409,-78,False,False
2147,45,36,726,325,419,321,-307,-4,False,False
2148,45,37,653,295,506,381,-147,86,False,True
2149,45,38,551,317,549,353,-2,36,False,True
2150,45,39,590,300,644,391,54,91,True,True
2151,45,40,688,332,803,345,115,13,True,True
2152,45,41,617,301,722,383,105,82,True,True
2153,45,42,575,324,756,359,181,35,True,True
2154,45,43,637,337,761,355,124,18,True,True
2155,45,44,628,333,706,346,78,13,True,True
2156,45,45,605,309,636,297,31,-12,True,False
2157,45,46,521,311,606,338,85,27,True,True
2158,45,47,479,260,665,324,186,64,True,True
2159,45,48,457,283,694,347,237,64,True,True
2160,46,1,0,0,8,2,8,2,True,True
2161,46,2,0,0,3,0,3,0,True,False
2162,46,3,0,1,5,6,5,5,True,True
2163,46,4,0,0,4,0,4,0,True,False
2164,46,5,0,0,1,1,1,1,True,True
2165,46,6,0,0,1,2,1,2,True,True
2166,46,7,0,0,1,2,1,2,True,True
2167,46,8,0,0,0,1,0,1,False,True
2168,46,9,0,0,0,1,0,1,False,True
2169,46,10,0,0,0,0,0,0,False,False
2170,46,11,0,0,1,0,1,0,True,False
2171,46,12,0,0,0,0,0,0,False,False
2172,46,13,0,0,0,0,0,0,False,False
2173,46,14,0,0,2,0,2,0,True,False
2174,46,15,0,0,1,2,1,2,True,True
2175,46,16,0,0,1,0,1,0,True,False
2176,46,17,0,0,0,2,0,2,False,True
2177,46,18,0,0,0,0,0,0,False,False
2178,46,19,0,0,0,0,0,0,False,False
2179,46,20,0,0,2,1,2,1,True,True
2180,46,21,0,0,0,0,0,0,False,False
2181,46,22,0,0,1,0,1,0,True,False
2182,46,23,0,0,3,1,3,1,True,True
2183,46,24,0,0,1,4,1,4,True,True
2184,46,25,0,0,1,2,1,2,True,True
2185,46,26,0,0,5,1,5,1,True,True
2186,46,27,0,0,1,0,1,0,True,False
2187,46,28,0,1,1,2,1,1,True,True
2188,46,29,0,0,0,2,0,2,False,True
2189,46,30,0,0,1,1,1,1,True,True
2190,46,31,0,0,1,1,1,1,True,True
2191,46,32,0,0,1,5,1,5,True,True
2192,46,33,0,0,1,2,1,2,True,True
2193,46,34,0,1,1,1,1,0,True,False
2194,46,35,0,0,2,1,2,1,True,True
2195,46,36,0,0,2,1,2,1,True,True
2196,46,37,0,0,1,1,1,1,True,True
2197,46,38,0,0,4,1,4,1,True,True
2198,46,39,0,0,1,2,1,2,True,True
2199,46,40,0,1,3,3,3,2,True,True
2200,46,41,1,0,5,1,4,1,True,True
2201,46,42,0,0,1,3,1,3,True,True
2202,46,43,0,0,0,2,0,2,False,True
2203,46,44,0,1,4,4,4,3,True,True
2204,46,45,1,0,4,1,3,1,True,True
2205,46,46,1,0,2,3,1,3,True,True
2206,46,47,0,0,10,1,10,1,True,True
2207,46,48,2,0,5,1,3,1,True,True
2208,47,1,3,0,26,9,23,9,True,True
2209,47,2,0,1,17,13,17,12,True,True
2210,47,3,2,2,12,9,10,7,True,True
2211,47,4,1,0,17,8,16,8,True,True
2212,47,5,0,0,11,15,11,15,True,True
2213,47,6,2,2,9,10,7,8,True,True
2214,47,7,0,0,8,11,8,11,True,True
2215,47,8,0,0,11,14,11,14,True,True
2216,47,9,1,2,9,18,8,16,True,True
2217,47,10,1,4,5,16,4,12,True,True
2218,47,11,1,3,5,9,4,6,True,True
2219,47,12,0,1,8,9,8,8,True,True
2220,47,13,2,1,9,11,7,10,True,True
2221,47,14,1,0,23,4,22,4,True,True
2222,47,15,2,4,26,5,24,1,True,True
2223,47,16,1,4,17,7,16,3,True,True
2224,47,17,3,1,27,4,24,3,True,True
2225,47,18,0,1,26,4,26,3,True,True
2226,47,19,2,3,14,6,12,3,True,True
2227,47,20,0,3,12,4,12,1,True,True
2228,47,21,1,3,8,10,7,7,True,True
2229,47,22,1,1,12,4,11,3,True,True
2230,47,23,1,3,4,3,3,0,True,False
2231,47,24,1,2,5,9,4,7,True,True
2232,47,25,1,2,14,4,13,2,True,True
2233,47,26,0,2,12,4,12,2,True,True
2234,47,27,0,2,11,7,11,5,True,True
2235,47,28,1,0,10,4,9,4,True,True
2236,47,29,0,1,9,4,9,3,True,True
2237,47,30,0,1,6,6,6,5,True,True
2238,47,31,1,0,5,2,4,2,True,True
2239,47,32,0,1,5,6,5,5,True,True
2240,47,33,0,0,9,2,9,2,True,True
2241,47,34,0,0,1,8,1,8,True,True
2242,47,35,0,1,3,2,3,1,True,True
2243,47,36,1,3,11,9,10,6,True,True
2244,47,37,3,2,2,4,-1,2,False,True
2245,47,38,3,1,15,8,12,7,True,True
2246,47,39,5,2,14,10,9,8,True,True
2247,47,40,3,2,9,7,6,5,True,True
2248,47,41,3,1,12,10,9,9,True,True
2249,47,42,4,2,12,3,8,1,True,True
2250,47,43,5,0,19,5,14,5,True,True
2251,47,44,4,1,25,15,21,14,True,True
2252,47,45,2,0,18,2,16,2,True,True
2253,47,46,1,0,12,6,11,6,True,True
2254,47,47,3,0,11,6,8,6,True,True
2255,47,48,1,1,21,10,20,9,True,True
2256,48,1,6797,6176,6443,4592,-354,-1584,False,False
2257,48,2,5628,6172,5060,4808,-568,-1364,False,False
2258,48,3,4368,5566,3851,4397,-517,-1169,False,False
2259,48,4,3453,4942,2959,3868,-494,-1074,False,False
2260,48,5,2839,4379,2406,3645,-433,-734,False,False
2261,48,6,2541,4015,1928,3330,-613,-685,False,False
2262,48,7,2141,3375,1613,3035,-528,-340,False,False
2263,48,8,1803,3170,1207,2456,-596,-714,False,False
2264,48,9,2021,2790,1131,2170,-890,-620,False,False
2265,48,10,1593,1788,934,1484,-659,-304,False,False
2266,48,11,1699,1256,662,866,-1037,-390,False,False
2267,48,12,3015,974,882,613,-2133,-361,False,False
2268,48,13,4930,972,1320,635,-3610,-337,False,False
2269,48,14,7635,1225,2056,764,-5579,-461,False,False
2270,48,15,8311,1311,2445,877,-5866,-434,False,False
2271,48,16,9287,1707,2997,1160,-6290,-547,False,False
2272,48,17,8952,1846,3571,1364,-5381,-482,False,False
2273,48,18,9201,2326,4474,1573,-4727,-753,False,False
2274,48,19,8402,2457,4627,1620,-3775,-837,False,False
2275,48,20,7939,3046,4788,1853,-3151,-1193,False,False
2276,48,21,6681,2990,4446,1975,-2235,-1015,False,False
2277,48,22,5827,3271,4268,2150,-1559,-1121,False,False
2278,48,23,5711,3287,4395,2303,-1316,-984,False,False
2279,48,24,5914,3464,5019,2802,-895,-662,False,False
2280,48,25,6085,3661,5627,3168,-458,-493,False,False
2281,48,26,5635,3600,5556,3179,-79,-421,False,False
2282,48,27,5275,3457,5235,3681,-40,224,False,True
2283,48,28,5440,3333,5290,3933,-150,600,False,True
2284,48,29,5007,3114,4976,3603,-31,489,False,True
2285,48,30,5133,3329,5297,3692,164,363,True,True
2286,48,31,4785,3010,5242,3176,457,166,True,True
2287,48,32,4457,3063,5083,3161,626,98,True,True
2288,48,33,4185,2837,4721,2996,536,159,True,True
2289,48,34,3923,2871,4108,2793,185,-78,True,False
2290,48,35,4538,2964,4481,2851,-57,-113,False,False
2291,48,36,5782,3687,6079,3841,297,154,True,True
2292,48,37,6848,3645,7400,4132,552,487,True,True
2293,48,38,8207,3863,8598,4245,391,382,True,True
2294,48,39,9079,4208,9202,4589,123,381,True,True
2295,48,40,9614,4415,10675,5453,1061,1038,True,True
2296,48,41,9285,4034,9951,4390,666,356,True,True
2297,48,42,9645,3883,9151,3899,-494,16,False,True
2298,48,43,9957,4144,9235,4005,-722,-139,False,False
2299,48,44,10653,4310,8841,3832,-1812,-478,False,False
2300,48,45,10064,4157,8850,3974,-1214,-183,False,False
2301,48,46,10422,4650,8866,4119,-1556,-531,False,False
2302,48,47,10096,4826,8973,4458,-1123,-368,False,False
2303,48,48,9230,4763,7987,4415,-1243,-348,False,False
2304,49,1,296,345,1293,639,997,294,True,True
2305,49,2,255,384,1263,775,1008,391,True,True
2306,49,3,194,394,1019,840,825,446,True,True
2307,49,4,119,310,736,910,617,600,True,True
2308,49,5,103,291,605,867,502,576,True,True
2309,49,6,79,261,503,809,424,548,True,True
2310,49,7,47,183,352,695,305,512,True,True
2311,49,8,36,134,292,607,256,473,True,True
2312,49,9,33,120,249,541,216,421,True,True
2313,49,10,29,74,214,406,185,332,True,True
2314,49,11,23,36,123,220,100,184,True,True
2315,49,12,22,33,100,127,78,94,True,True
2316,49,13,31,16,79,86,48,70,True,True
2317,49,14,28,23,61,67,33,44,True,True
2318,49,15,43,10,77,58,34,48,True,True
2319,49,16,49,17,55,46,6,29,True,True
2320,49,17,36,15,61,54,25,39,True,True
2321,49,18,38,16,93,62,55,46,True,True
2322,49,19,47,27,97,72,50,45,True,True
2323,49,20,41,40,100,66,59,26,True,True
2324,49,21,42,33,106,85,64,52,True,True
2325,49,22,16,44,84,102,68,58,True,True
2326,49,23,20,53,100,142,80,89,True,True
2327,49,24,23,48,114,118,91,70,True,True
2328,49,25,26,42,120,112,94,70,True,True
2329,49,26,21,36,111,120,90,84,True,True
2330,49,27,26,55,118,143,92,88,True,True
2331,49,28,26,44,134,114,108,70,True,True
2332,49,29,27,46,149,151,122,105,True,True
2333,49,30,22,44,144,119,122,75,True,True
2334,49,31,27,41,179,131,152,90,True,True
2335,49,32,41,57,163,134,122,77,True,True
2336,49,33,28,35,173,117,145,82,True,True
2337,49,34,22,45,119,144,97,99,True,True
2338,49,35,39,45,177,166,138,121,True,True
2339,49,36,61,62,242,169,181,107,True,True
2340,49,37,76,56,311,203,235,147,True,True
2341,49,38,64,64,374,215,310,151,True,True
2342,49,39,83,82,498,246,415,164,True,True
2343,49,40,115,79,548,223,433,144,True,True
2344,49,41,108,70,636,272,528,202,True,True
2345,49,42,145,96,725,279,580,183,True,True
2346,49,43,198,136,953,290,755,154,True,True
2347,49,44,198,128,1141,342,943,214,True,True
2348,49,45,241,143,1212,353,971,210,True,True
2349,49,46,317,179,1299,398,982,219,True,True
2350,49,47,351,198,1380,496,1029,298,True,True
2351,49,48,351,229,1424,603,1073,374,True,True
2352,50,1,1561,1788,1857,2230,296,442,True,True
2353,50,2,1280,1870,1525,2257,245,387,True,True
2354,50,3,1020,1898,1156,1918,136,20,True,True
2355,50,4,759,1813,1015,1668,256,-145,True,False
2356,50,5,723,1908,822,1480,99,-428,True,False
2357,50,6,556,1875,647,1240,91,-635,True,False
2358,50,7,524,1731,587,1191,63,-540,True,False
2359,50,8,481,1537,448,970,-33,-567,False,False
2360,50,9,552,1548,423,913,-129,-635,False,False
2361,50,10,394,1107,331,601,-63,-506,False,False
2362,50,11,393,790,310,352,-83,-438,False,False
2363,50,12,490,622,358,215,-132,-407,False,False
2364,50,13,792,406,718,213,-74,-193,False,False
2365,50,14,1328,376,1327,286,-1,-90,False,False
2366,50,15,1957,432,1398,318,-559,-114,False,False
2367,50,16,2737,795,1604,383,-1133,-412,False,False
2368,50,17,3202,963,2114,522,-1088,-441,False,False
2369,50,18,3578,1006,2746,724,-832,-282,False,False
2370,50,19,3486,1173,3388,992,-98,-181,False,False
2371,50,20,3234,1407,3323,1226,89,-181,True,False
2372,50,21,2670,1379,3113,1281,443,-98,True,False
2373,50,22,2553,1308,2533,1394,-20,86,False,True
2374,50,23,2457,1207,2551,1591,94,384,True,True
2375,50,24,2538,1310,2483,1677,-55,367,False,True
2376,50,25,2530,1411,2509,1678,-21,267,False,True
2377,50,26,2706,1782,2562,1488,-144,-294,False,False
2378,50,27,2443,1469,2470,1538,27,69,True,True
2379,50,28,2261,1331,2411,1437,150,106,True,True
2380,50,29,2236,1293,2481,1388,245,95,True,True
2381,50,30,2148,1179,2377,1319,229,140,True,True
2382,50,31,2020,1211,2213,1368,193,157,True,True
2383,50,32,1991,1230,2251,1189,260,-41,True,False
2384,50,33,1832,1030,1894,1089,62,59,True,True
2385,50,34,1735,977,1638,919,-97,-58,False,False
2386,50,35,2010,1065,1748,905,-262,-160,False,False
2387,50,36,2340,1191,2481,1182,141,-9,True,False
2388,50,37,2771,1285,2927,1404,156,119,True,True
2389,50,38,2969,1164,3199,1380,230,216,True,True
2390,50,39,3103,1137,3287,1364,184,227,True,True
2391,50,40,3021,1206,3287,1344,266,138,True,True
2392,50,41,3038,1082,3229,1248,191,166,True,True
2393,50,42,3028,1141,2983,1188,-45,47,False,True
2394,50,43,2940,1204,2882,1231,-58,27,False,True
2395,50,44,2688,1093,2805,1284,117,191,True,True
2396,50,45,2738,1104,2921,1254,183,150,True,True
2397,50,46,2494,1213,2903,1544,409,331,True,True
2398,50,47,2484,1339,2984,1670,500,331,True,True
2399,50,48,2268,1276,2799,2045,531,769,True,True
2400,51,1,2,2,34,13,32,11,True,True
2401,51,2,0,0,19,12,19,12,True,True
2402,51,3,0,0,14,11,14,11,True,True
2403,51,4,0,3,13,13,13,10,True,True
2404,51,5,1,1,11,14,10,13,True,True
2405,51,6,1,0,20,15,19,15,True,True
2406,51,7,1,0,8,11,7,11,True,True
2407,51,8,0,1,5,23,5,22,True,True
2408,51,9,1,0,10,16,9,16,True,True
2409,51,10,0,1,9,7,9,6,True,True
2410,51,11,1,2,10,7,9,5,True,True
2411,51,12,0,0,5,4,5,4,True,True
2412,51,13,0,0,4,5,4,5,True,True
2413,51,14,0,0,3,5,3,5,True,True
2414,51,15,1,0,8,11,7,11,True,True
2415,51,16,0,0,3,12,3,12,True,True
2416,51,17,0,0,12,2,12,2,True,True
2417,51,18,0,0,2,7,2,7,True,True
2418,51,19,0,0,5,6,5,6,True,True
2419,51,20,0,0,9,5,9,5,True,True
2420,51,21,0,0,7,3,7,3,True,True
2421,51,22,1,0,4,5,3,5,True,True
2422,51,23,1,0,6,0,5,0,True,False
2423,51,24,0,0,10,3,10,3,True,True
2424,51,25,1,0,8,3,7,3,True,True
2425,51,26,1,0,10,5,9,5,True,True
2426,51,27,0,0,9,8,9,8,True,True
2427,51,28,0,0,6,4,6,4,True,True
2428,51,29,1,0,3,2,2,2,True,True
2429,51,30,0,0,10,8,10,8,True,True
2430,51,31,0,0,6,6,6,6,True,True
2431,51,32,0,1,5,3,5,2,True,True
2432,51,33,0,0,7,4,7,4,True,True
2433,51,34,0,0,16,4,16,4,True,True
2434,51,35,0,0,4,6,4,6,True,True
2435,51,36,0,0,9,9,9,9,True,True
2436,51,37,0,1,9,9,9,8,True,True
2437,51,38,1,0,10,8,9,8,True,True
2438,51,39,0,0,8,8,8,8,True,True
2439,51,40,0,0,17,7,17,7,True,True
2440,51,41,0,0,17,8,17,8,True,True
2441,51,42,1,0,20,1,19,1,True,True
2442,51,43,1,0,17,4,16,4,True,True
2443,51,44,0,0,27,11,27,11,True,True
2444,51,45,0,0,25,8,25,8,True,True
2445,51,46,0,0,20,6,20,6,True,True
2446,51,47,0,0,24,7,24,7,True,True
2447,51,48,2,0,23,6,21,6,True,True
2448,52,1,152,204,405,180,253,-24,True,False
2449,52,2,120,195,357,244,237,49,True,True
2450,52,3,74,142,227,228,153,86,True,True
2451,52,4,49,110,151,222,102,112,True,True
2452,52,5,33,90,142,200,109,110,True,True
2453,52,6,27,83,102,174,75,91,True,True
2454,52,7,20,43,58,129,38,86,True,True
2455,52,8,20,51,60,115,40,64,True,True
2456,52,9,33,31,40,100,7,69,True,True
2457,52,10,48,19,47,51,-1,32,False,True
2458,52,11,73,22,27,27,-46,5,False,True
2459,52,12,109,30,23,23,-86,-7,False,False
2460,52,13,177,37,36,14,-141,-23,False,False
2461,52,14,338,62,77,25,-261,-37,False,False
2462,52,15,472,63,79,26,-393,-37,False,False
2463,52,16,578,70,44,18,-534,-52,False,False
2464,52,17,679,86,79,25,-600,-61,False,False
2465,52,18,566,109,69,20,-497,-89,False,False
2466,52,19,463,113,53,39,-410,-74,False,False
2467,52,20,332,132,62,50,-270,-82,False,False
2468,52,21,258,157,52,54,-206,-103,False,False
2469,52,22,254,136,70,49,-184,-87,False,False
2470,52,23,176,147,61,52,-115,-95,False,False
2471,52,24,174,148,68,53,-106,-95,False,False
2472,52,25,180,147,62,63,-118,-84,False,False
2473,52,26,125,155,79,67,-46,-88,False,False
2474,52,27,141,146,86,62,-55,-84,False,False
2475,52,28,127,148,80,76,-47,-72,False,False
2476,52,29,145,122,86,76,-59,-46,False,False
2477,52,30,139,127,102,75,-37,-52,False,False
2478,52,31,158,114,99,89,-59,-25,False,False
2479,52,32,123,125,126,65,3,-60,True,False
2480,52,33,106,128,111,85,5,-43,True,False
2481,52,34,125,117,101,67,-24,-50,False,False
2482,52,35,148,135,109,80,-39,-55,False,False
2483,52,36,188,170,132,86,-56,-84,False,False
2484,52,37,219,174,216,115,-3,-59,False,False
2485,52,38,251,167,269,104,18,-63,True,False
2486,52,39,243,178,349,120,106,-58,True,False
2487,52,40,245,162,365,115,120,-47,True,False
2488,52,41,279,141,417,128,138,-13,True,False
2489,52,42,191,130,445,105,254,-25,True,False
2490,52,43,243,134,491,120,248,-14,True,False
2491,52,44,259,116,506,113,247,-3,True,False
2492,52,45,276,143,548,162,272,19,True,True
2493,52,46,296,161,550,154,254,-7,True,False
2494,52,47,295,180,527,166,232,-14,True,False
2495,52,48,251,154,532,197,281,43,True,True
2496,53,1,1,0,31,14,30,14,True,True
2497,53,2,0,0,27,14,27,14,True,True
2498,53,3,0,0,26,9,26,9,True,True
2499,53,4,1,1,28,17,27,16,True,True
2500,53,5,1,1,11,10,10,9,True,True
2501,53,6,3,0,15,10,12,10,True,True
2502,53,7,0,0,12,9,12,9,True,True
2503,53,8,0,0,10,14,10,14,True,True
2504,53,9,0,0,7,17,7,17,True,True
2505,53,10,1,0,7,13,6,13,True,True
2506,53,11,1,2,11,11,10,9,True,True
2507,53,12,1,0,11,6,10,6,True,True
2508,53,13,2,2,10,7,8,5,True,True
2509,53,14,0,0,18,9,18,9,True,True
2510,53,15,0,0,13,0,13,0,True,False
2511,53,16,0,0,10,8,10,8,True,True
2512,53,17,1,0,10,4,9,4,True,True
2513,53,18,1,0,11,4,10,4,True,True
2514,53,19,1,1,17,7,16,6,True,True
2515,53,20,1,1,16,8,15,7,True,True
2516,53,21,3,1,18,11,15,10,True,True
2517,53,22,1,1,21,13,20,12,True,True
2518,53,23,1,1,16,4,15,3,True,True
2519,53,24,2,0,13,4,11,4,True,True
2520,53,25,3,1,7,2,4,1,True,True
2521,53,26,1,0,8,4,7,4,True,True
2522,53,27,3,0,13,7,10,7,True,True
2523,53,28,2,1,23,4,21,3,True,True
2524,53,29,0,0,7,3,7,3,True,True
2525,53,30,0,0,6,7,6,7,True,True
2526,53,31,1,0,21,7,20,7,True,True
2527,53,32,6,1,26,5,20,4,True,True
2528,53,33,2,1,10,8,8,7,True,True
2529,53,34,0,2,11,14,11,12,True,True
2530,53,35,1,1,10,4,9,3,True,True
2531,53,36,1,0,9,8,8,8,True,True
2532,53,37,3,1,18,10,15,9,True,True
2533,53,38,4,3,21,16,17,13,True,True
2534,53,39,3,2,27,9,24,7,True,True
2535,53,40,1,0,18,8,17,8,True,True
2536,53,41,3,1,21,9,18,8,True,True
2537,53,42,1,1,20,13,19,12,True,True
2538,53,43,1,0,30,16,29,16,True,True
2539,53,44,4,2,28,13,24,11,True,True
2540,53,45,1,0,39,10,38,10,True,True
2541,53,46,4,1,32,11,28,10,True,True
2542,53,47,2,1,30,9,28,8,True,True
2543,53,48,2,1,35,11,33,10,True,True
2544,54,1,19,25,146,83,127,58,True,True
2545,54,2,19,23,153,88,134,65,True,True
2546,54,3,11,12,111,116,100,104,True,True
2547,54,4,6,9,81,85,75,76,True,True
2548,54,5,5,12,63,91,58,79,True,True
2549,54,6,2,12,48,74,46,62,True,True
2550,54,7,0,7,28,62,28,55,True,True
2551,54,8,3,7,31,66,28,59,True,True
2552,54,9,2,8,20,45,18,37,True,True
2553,54,10,4,3,16,38,12,35,True,True
2554,54,11,2,1,8,20,6,19,True,True
2555,54,12,5,0,6,8,1,8,True,True
2556,54,13,14,1,16,8,2,7,True,True
2557,54,14,35,3,18,9,-17,6,False,True
2558,54,15,53,3,17,5,-36,2,False,True
2559,54,16,43,4,26,9,-17,5,False,True
2560,54,17,33,2,22,9,-11,7,False,True
2561,54,18,27,3,26,15,-1,12,False,True
2562,54,19,10,10,22,15,12,5,True,True
2563,54,20,7,8,27,21,20,13,True,True
2564,54,21,6,9,18,20,12,11,True,True
2565,54,22,6,15,13,17,7,2,True,True
2566,54,23,10,9,17,36,7,27,True,True
2567,54,24,6,12,25,26,19,14,True,True
2568,54,25,4,6,31,26,27,20,True,True
2569,54,26,4,12,33,22,29,10,True,True
2570,54,27,1,6,16,27,15,21,True,True
2571,54,28,1,7,28,20,27,13,True,True
2572,54,29,6,7,19,34,13,27,True,True
2573,54,30,0,9,34,25,34,16,True,True
2574,54,31,7,8,36,30,29,22,True,True
2575,54,32,5,3,29,32,24,29,True,True
2576,54,33,9,13,31,29,22,16,True,True
2577,54,34,4,12,32,30,28,18,True,True
2578,54,35,6,9,25,39,19,30,True,True
2579,54,36,15,10,38,46,23,36,True,True
2580,54,37,16,20,76,59,60,39,True,True
2581,54,38,15,20,91,44,76,24,True,True
2582,54,39,10,16,104,64,94,48,True,True
2583,54,40,21,12,119,54,98,42,True,True
2584,54,41,20,12,148,43,128,31,True,True
2585,54,42,13,19,160,53,147,34,True,True
2586,54,43,25,10,166,52,141,42,True,True
2587,54,44,30,13,167,49,137,36,True,True
2588,54,45,34,17,169,56,135,39,True,True
2589,54,46,43,16,189,60,146,44,True,True
2590,54,47,31,23,156,47,125,24,True,True
2591,54,48,27,19,200,66,173,47,True,True
2592,55,1,0,1,27,9,27,8,True,True
2593,55,2,0,0,22,15,22,15,True,True
2594,55,3,2,1,24,9,22,8,True,True
2595,55,4,1,0,19,13,18,13,True,True
2596,55,5,0,0,16,19,16,19,True,True
2597,55,6,0,0,6,17,6,17,True,True
2598,55,7,0,0,10,14,10,14,True,True
2599,55,8,0,0,6,14,6,14,True,True
2600,55,9,0,1,7,18,7,17,True,True
2601,55,10,0,1,5,17,5,16,True,True
2602,55,11,0,1,6,14,6,13,True,True
2603,55,12,0,0,5,14,5,14,True,True
2604,55,13,0,0,8,3,8,3,True,True
2605,55,14,0,0,5,9,5,9,True,True
2606,55,15,0,1,3,4,3,3,True,True
2607,55,16,1,0,3,3,2,3,True,True
2608,55,17,1,3,11,6,10,3,True,True
2609,55,18,0,0,10,7,10,7,True,True
2610,55,19,1,0,6,4,5,4,True,True
2611,55,20,1,0,7,7,6,7,True,True
2612,55,21,1,0,9,11,8,11,True,True
2613,55,22,1,0,11,8,10,8,True,True
2614,55,23,1,1,7,11,6,10,True,True
2615,55,24,0,0,15,12,15,12,True,True
2616,55,25,0,0,17,17,17,17,True,True
2617,55,26,0,1,9,17,9,16,True,True
2618,55,27,1,0,13,19,12,19,True,True
2619,55,28,1,2,16,18,15,16,True,True
2620,55,29,0,1,15,17,15,16,True,True
2621,55,30,0,0,14,14,14,14,True,True
2622,55,31,0,3,17,18,17,15,True,True
2623,55,32,0,1,6,19,6,18,True,True
2624,55,33,2,2,14,13,12,11,True,True
2625,55,34,0,0,12,9,12,9,True,True
2626,55,35,1,1,15,9,14,8,True,True
2627,55,36,0,1,8,11,8,10,True,True
2628,55,37,0,2,10,18,10,16,True,True
2629,55,38,0,0,20,12,20,12,True,True
2630,55,39,2,1,17,18,15,17,True,True
2631,55,40,0,3,20,18,20,15,True,True
2632,55,41,1,2,34,10,33,8,True,True
2633,55,42,1,0,14,11,13,11,True,True
2634,55,43,0,0,20,8,20,8,True,True
2635,55,44,0,1,26,8,26,7,True,True
2636,55,45,2,1,26,9,24,8,True,True
2637,55,46,1,0,17,9,16,9,True,True
2638,55,47,0,0,30,7,30,7,True,True
2639,55,48,1,0,36,11,35,11,True,True
2640,56,1,8,4,115,46,107,42,True,True
2641,56,2,18,0,121,49,103,49,True,True
2642,56,3,7,4,108,62,101,58,True,True
2643,56,4,6,2,91,67,85,65,True,True
2644,56,5,3,1,76,87,73,86,True,True
2645,56,6,6,5,74,78,68,73,True,True
2646,56,7,6,3,71,53,65,50,True,True
2647,56,8,6,2,44,69,38,67,True,True
2648,56,9,5,3,40,98,35,95,True,True
2649,56,10,2,4,45,73,43,69,True,True
2650,56,11,3,1,31,47,28,46,True,True
2651,56,12,4,3,23,37,19,34,True,True
2652,56,13,2,2,16,26,14,24,True,True
2653,56,14,3,4,19,19,16,15,True,True
2654,56,15,1,5,14,17,13,12,True,True
2655,56,16,4,4,14,10,10,6,True,True
2656,56,17,2,4,18,8,16,4,True,True
2657,56,18,7,0,24,8,17,8,True,True
2658,56,19,3,1,19,7,16,6,True,True
2659,56,20,3,1,18,12,15,11,True,True
2660,56,21,3,5,30,13,27,8,True,True
2661,56,22,4,0,22,11,18,11,True,True
2662,56,23,4,1,23,17,19,16,True,True
2663,56,24,1,5,19,9,18,4,True,True
2664,56,25,1,5,15,13,14,8,True,True
2665,56,26,1,2,23,13,22,11,True,True
2666,56,27,6,9,21,12,15,3,True,True
2667,56,28,6,5,31,16,25,11,True,True
2668,56,29,3,6,24,15,21,9,True,True
2669,56,30,7,5,22,18,15,13,True,True
2670,56,31,7,4,33,16,26,12,True,True
2671,56,32,5,2,26,15,21,13,True,True
2672,56,33,8,3,21,15,13,12,True,True
2673,56,34,3,3,19,9,16,6,True,True
2674,56,35,10,4,23,19,13,15,True,True
2675,56,36,2,1,34,19,32,18,True,True
2676,56,37,2,1,24,19,22,18,True,True
2677,56,38,4,6,26,19,22,13,True,True
2678,56,39,3,4,41,19,38,15,True,True
2679,56,40,6,3,44,18,38,15,True,True
2680,56,41,10,4,48,24,38,20,True,True
2681,56,42,4,2,50,25,46,23,True,True
2682,56,43,4,4,38,17,34,13,True,True
2683,56,44,11,3,77,24,66,21,True,True
2684,56,45,7,5,82,35,75,30,True,True
2685,56,46,8,7,78,48,70,41,True,True
2686,56,47,8,5,76,34,68,29,True,True
2687,56,48,5,10,102,47,97,37,True,True
2688,57,1,1,0,11,4,10,4,True,True
2689,57,2,1,0,15,5,14,5,True,True
2690,57,3,2,0,11,6,9,6,True,True
2691,57,4,0,1,12,7,12,6,True,True
2692,57,5,0,0,8,6,8,6,True,True
2693,57,6,0,1,10,7,10,6,True,True
2694,57,7,0,0,4,8,4,8,True,True
2695,57,8,1,1,5,6,4,5,True,True
2696,57,9,0,0,3,6,3,6,True,True
2697,57,10,0,1,2,4,2,3,True,True
2698,57,11,1,0,3,6,2,6,True,True
2699,57,12,0,0,3,1,3,1,True,True
2700,57,13,0,0,1,2,1,2,True,True
2701,57,14,1,0,0,0,-1,0,False,False
2702,57,15,1,0,1,0,0,0,False,False
2703,57,16,1,0,3,1,2,1,True,True
2704,57,17,0,0,0,2,0,2,False,True
2705,57,18,0,0,4,1,4,1,True,True
2706,57,19,1,0,1,2,0,2,False,True
2707,57,20,2,1,1,0,-1,-1,False,False
2708,57,21,1,0,4,2,3,2,True,True
2709,57,22,0,0,2,0,2,0,True,False
2710,57,23,0,1,3,2,3,1,True,True
2711,57,24,0,0,0,3,0,3,False,True
2712,57,25,0,0,4,1,4,1,True,True
2713,57,26,0,0,5,1,5,1,True,True
2714,57,27,2,0,6,2,4,2,True,True
2715,57,28,0,1,1,1,1,0,True,False
2716,57,29,3,0,3,3,0,3,False,True
2717,57,30,0,2,2,2,2,0,True,False
2718,57,31,0,2,2,5,2,3,True,True
2719,57,32,0,2,2,3,2,1,True,True
2720,57,33,1,1,0,4,-1,3,False,True
2721,57,34,1,0,4,0,3,0,True,False
2722,57,35,1,0,8,1,7,1,True,True
2723,57,36,2,2,4,3,2,1,True,True
2724,57,37,0,0,3,2,3,2,True,True
2725,57,38,0,0,10,3,10,3,True,True
2726,57,39,0,0,5,5,5,5,True,True
2727,57,40,0,0,8,2,8,2,True,True
2728,57,41,1,0,10,3,9,3,True,True
2729,57,42,2,1,5,7,3,6,True,True
2730,57,43,0,0,5,2,5,2,True,True
2731,57,44,0,1,8,6,8,5,True,True
2732,57,45,0,2,9,3,9,1,True,True
2733,57,46,0,0,8,4,8,4,True,True
2734,57,47,0,0,9,10,9,10,True,True
2735,57,48,1,0,15,5,14,5,True,True
2736,58,1,0,0,9,4,9,4,True,True
2737,58,2,0,0,5,2,5,2,True,True
2738,58,3,0,0,5,7,5,7,True,True
2739,58,4,1,0,8,6,7,6,True,True
2740,58,5,0,0,5,4,5,4,True,True
2741,58,6,0,1,4,10,4,9,True,True
2742,58,7,2,0,2,5,0,5,False,True
2743,58,8,0,0,0,1,0,1,False,True
2744,58,9,0,0,3,2,3,2,True,True
2745,58,10,0,0,2,5,2,5,True,True
2746,58,11,0,0,1,1,1,1,True,True
2747,58,12,0,0,3,4,3,4,True,True
2748,58,13,0,0,1,0,1,0,True,False
2749,58,14,0,0,0,1,0,1,False,True
2750,58,15,0,0,1,1,1,1,True,True
2751,58,16,1,0,0,0,-1,0,False,False
2752,58,17,0,0,0,0,0,0,False,False
2753,58,18,0,0,1,1,1,1,True,True
2754,58,19,0,0,2,1,2,1,True,True
2755,58,20,0,0,1,1,1,1,True,True
2756,58,21,0,0,1,2,1,2,True,True
2757,58,22,0,0,2,1,2,1,True,True
2758,58,23,0,0,1,1,1,1,True,True
2759,58,24,0,0,1,2,1,2,True,True
2760,58,25,0,0,0,0,0,0,False,False
2761,58,26,0,0,0,2,0,2,False,True
2762,58,27,0,0,1,2,1,2,True,True
2763,58,28,0,0,2,0,2,0,True,False
2764,58,29,0,0,3,2,3,2,True,True
2765,58,30,0,0,1,2,1,2,True,True
2766,58,31,0,0,1,0,1,0,True,False
2767,58,32,1,0,3,1,2,1,True,True
2768,58,33,0,0,2,1,2,1,True,True
2769,58,34,0,0,5,2,5,2,True,True
2770,58,35,0,0,1,2,1,2,True,True
2771,58,36,0,0,0,1,0,1,False,True
2772,58,37,0,0,3,2,3,2,True,True
2773,58,38,0,0,2,4,2,4,True,True
2774,58,39,0,0,2,1,2,1,True,True
2775,58,40,0,0,3,1,3,1,True,True
2776,58,41,0,0,1,0,1,0,True,False
2777,58,42,0,0,6,2,6,2,True,True
2778,58,43,1,0,7,2,6,2,True,True
2779,58,44,0,0,6,1,6,1,True,True
2780,58,45,0,0,10,2,10,2,True,True
2781,58,46,1,0,11,0,10,0,True,False
2782,58,47,1,0,9,2,8,2,True,True
2783,58,48,0,0,11,4,11,4,True,True
2784,59,1,0,0,0,0,0,0,False,False
2785,59,2,0,0,1,0,1,0,True,False
2786,59,3,0,0,2,0,2,0,True,False
2787,59,4,0,0,0,0,0,0,False,False
2788,59,5,0,0,0,0,0,0,False,False
2789,59,6,0,0,0,0,0,0,False,False
2790,59,7,0,0,0,0,0,0,False,False
2791,59,8,0,0,0,0,0,0,False,False
2792,59,9,0,0,1,7,1,7,True,True
2793,59,10,0,0,0,1,0,1,False,True
2794,59,11,0,0,1,0,1,0,True,False
2795,59,12,0,0,0,0,0,0,False,False
2796,59,13,0,0,0,1,0,1,False,True
2797,59,14,0,0,1,0,1,0,True,False
2798,59,15,0,0,1,0,1,0,True,False
2799,59,16,0,0,0,0,0,0,False,False
2800,59,17,0,0,0,0,0,0,False,False
2801,59,18,0,0,0,0,0,0,False,False
2802,59,19,0,0,0,0,0,0,False,False
2803,59,20,0,0,0,0,0,0,False,False
2804,59,21,0,0,1,1,1,1,True,True
2805,59,22,0,0,0,1,0,1,False,True
2806,59,23,0,0,0,1,0,1,False,True
2807,59,24,0,0,0,1,0,1,False,True
2808,59,25,0,0,0,0,0,0,False,False
2809,59,26,0,0,0,0,0,0,False,False
2810,59,27,0,0,0,0,0,0,False,False
2811,59,28,0,0,1,0,1,0,True,False
2812,59,29,0,0,1,1,1,1,True,True
2813,59,30,0,0,0,1,0,1,False,True
2814,59,31,0,0,0,1,0,1,False,True
2815,59,32,0,0,1,1,1,1,True,True
2816,59,33,0,0,0,1,0,1,False,True
2817,59,34,0,0,0,1,0,1,False,True
2818,59,35,0,0,0,0,0,0,False,False
2819,59,36,0,0,0,1,0,1,False,True
2820,59,37,0,0,0,0,0,0,False,False
2821,59,38,0,0,0,1,0,1,False,True
2822,59,39,0,0,0,0,0,0,False,False
2823,59,40,0,0,0,1,0,1,False,True
2824,59,41,0,0,1,0,1,0,True,False
2825,59,42,0,0,0,1,0,1,False,True
2826,59,43,0,0,0,0,0,0,False,False
2827,59,44,0,0,0,0,0,0,False,False
2828,59,45,0,0,0,0,0,0,False,False
2829,59,46,0,0,1,1,1,1,True,True
2830,59,47,0,0,0,2,0,2,False,True
2831,59,48,0,0,1,1,1,1,True,True
2832,60,1,1,1,12,8,11,7,True,True
2833,60,2,2,0,21,8,19,8,True,True
2834,60,3,2,1,20,11,18,10,True,True
2835,60,4,1,1,16,8,15,7,True,True
2836,60,5,0,0,11,12,11,12,True,True
2837,60,6,2,1,10,10,8,9,True,True
2838,60,7,0,1,9,15,9,14,True,True
2839,60,8,0,1,6,19,6,18,True,True
2840,60,9,2,2,13,15,11,13,True,True
2841,60,10,3,2,8,13,5,11,True,True
2842,60,11,0,1,9,11,9,10,True,True
2843,60,12,0,3,7,11,7,8,True,True
2844,60,13,0,2,1,8,1,6,True,True
2845,60,14,1,1,4,5,3,4,True,True
2846,60,15,0,1,2,5,2,4,True,True
2847,60,16,1,0,5,2,4,2,True,True
2848,60,17,1,0,6,2,5,2,True,True
2849,60,18,3,0,9,3,6,3,True,True
2850,60,19,1,0,3,1,2,1,True,True
2851,60,20,0,1,4,1,4,0,True,False
2852,60,21,0,0,9,1,9,1,True,True
2853,60,22,0,0,4,5,4,5,True,True
2854,60,23,0,0,5,2,5,2,True,True
2855,60,24,0,0,2,5,2,5,True,True
2856,60,25,1,0,4,5,3,5,True,True
2857,60,26,1,0,5,1,4,1,True,True
2858,60,27,0,0,9,1,9,1,True,True
2859,60,28,2,0,3,4,1,4,True,True
2860,60,29,0,0,11,4,11,4,True,True
2861,60,30,0,1,4,1,4,0,True,False
2862,60,31,0,0,5,4,5,4,True,True
2863,60,32,1,1,8,1,7,0,True,False
2864,60,33,0,1,4,2,4,1,True,True
2865,60,34,0,0,3,5,3,5,True,True
2866,60,35,3,0,3,3,0,3,False,True
2867,60,36,7,0,4,2,-3,2,False,True
2868,60,37,5,1,10,4,5,3,True,True
2869,60,38,2,3,9,8,7,5,True,True
2870,60,39,0,4,7,5,7,1,True,True
2871,60,40,1,4,8,5,7,1,True,True
2872,60,41,2,0,8,3,6,3,True,True
2873,60,42,0,3,7,5,7,2,True,True
2874,60,43,2,2,7,6,5,4,True,True
2875,60,44,0,2,12,11,12,9,True,True
2876,60,45,1,1,11,6,10,5,True,True
2877,60,46,0,2,21,5,21,3,True,True
2878,60,47,2,2,13,6,11,4,True,True
2879,60,48,0,1,14,7,14,6,True,True
2880,61,1,114,142,1125,534,1011,392,True,True
2881,61,2,120,165,1109,674,989,509,True,True
2882,61,3,88,184,1071,790,983,606,True,True
2883,61,4,64,188,769,805,705,617,True,True
2884,61,5,67,171,652,848,585,677,True,True
2885,61,6,42,148,551,785,509,637,True,True
2886,61,7,32,121,419,758,387,637,True,True
2887,61,8,29,97,368,660,339,563,True,True
2888,61,9,33,91,350,641,317,550,True,True
2889,61,10,26,60,279,477,253,417,True,True
2890,61,11,20,29,177,299,157,270,True,True
2891,61,12,15,30,103,211,88,181,True,True
2892,61,13,19,22,71,111,52,89,True,True
2893,61,14,17,18,75,76,58,58,True,True
2894,61,15,22,14,73,52,51,38,True,True
2895,61,16,15,10,60,51,45,41,True,True
2896,61,17,14,8,68,34,54,26,True,True
2897,61,18,12,10,60,48,48,38,True,True
2898,61,19,14,14,73,30,59,16,True,True
2899,61,20,9,12,62,57,53,45,True,True
2900,61,21,8,13,58,69,50,56,True,True
2901,61,22,6,15,56,56,50,41,True,True
2902,61,23,4,17,60,57,56,40,True,True
2903,61,24,9,11,76,51,67,40,True,True
2904,61,25,13,13,77,64,64,51,True,True
2905,61,26,12,14,81,80,69,66,True,True
2906,61,27,10,12,85,59,75,47,True,True
2907,61,28,7,10,81,80,74,70,True,True
2908,61,29,15,13,101,64,86,51,True,True
2909,61,30,11,21,88,99,77,78,True,True
2910,61,31,16,15,106,88,90,73,True,True
2911,61,32,19,16,118,80,99,64,True,True
2912,61,33,12,9,107,81,95,72,True,True
2913,61,34,10,12,83,98,73,86,True,True
2914,61,35,21,17,114,90,93,73,True,True
2915,61,36,25,18,113,105,88,87,True,True
2916,61,37,26,16,182,118,156,102,True,True
2917,61,38,18,19,190,117,172,98,True,True
2918,61,39,29,18,225,159,196,141,True,True
2919,61,40,35,25,285,152,250,127,True,True
2920,61,41,38,27,326,176,288,149,True,True
2921,61,42,44,31,401,194,357,163,True,True
2922,61,43,49,39,478,202,429,163,True,True
2923,61,44,56,41,624,229,568,188,True,True
2924,61,45,89,50,737,299,648,249,True,True
2925,61,46,97,55,841,313,744,258,True,True
2926,61,47,124,76,986,406,862,330,True,True
2927,61,48,135,96,1047,440,912,344,True,True
2928,62,1,18,25,266,104,248,79,True,True
2929,62,2,25,25,308,164,283,139,True,True
2930,62,3,20,28,264,188,244,160,True,True
2931,62,4,16,13,218,203,202,190,True,True
2932,62,5,8,17,183,191,175,174,True,True
2933,62,6,11,15,119,178,108,163,True,True
2934,62,7,15,22,123,175,108,153,True,True
2935,62,8,5,7,79,149,74,142,True,True
2936,62,9,4,16,66,136,62,120,True,True
2937,62,10,9,8,69,119,60,111,True,True
2938,62,11,2,5,47,75,45,70,True,True
2939,62,12,2,4,28,39,26,35,True,True
2940,62,13,7,4,31,16,24,12,True,True
2941,62,14,5,4,26,21,21,17,True,True
2942,62,15,2,0,12,16,10,16,True,True
2943,62,16,4,2,37,9,33,7,True,True
2944,62,17,4,3,29,16,25,13,True,True
2945,62,18,9,2,27,13,18,11,True,True
2946,62,19,3,5,35,18,32,13,True,True
2947,62,20,4,4,33,22,29,18,True,True
2948,62,21,0,1,25,11,25,10,True,True
2949,62,22,1,2,20,20,19,18,True,True
2950,62,23,3,6,30,17,27,11,True,True
2951,62,24,3,3,29,26,26,23,True,True
2952,62,25,2,2,30,19,28,17,True,True
2953,62,26,3,2,22,16,19,14,True,True
2954,62,27,2,3,37,26,35,23,True,True
2955,62,28,2,4,31,15,29,11,True,True
2956,62,29,4,4,35,15,31,11,True,True
2957,62,30,3,2,51,21,48,19,True,True
2958,62,31,4,7,32,25,28,18,True,True
2959,62,32,3,2,29,20,26,18,True,True
2960,62,33,1,8,33,24,32,16,True,True
2961,62,34,4,3,32,32,28,29,True,True
2962,62,35,4,2,45,32,41,30,True,True
2963,62,36,12,2,42,33,30,31,True,True
2964,62,37,12,5,61,36,49,31,True,True
2965,62,38,6,5,56,33,50,28,True,True
2966,62,39,5,7,62,37,57,30,True,True
2967,62,40,4,3,66,48,62,45,True,True
2968,62,41,13,9,99,43,86,34,True,True
2969,62,42,17,8,91,52,74,44,True,True
2970,62,43,14,5,100,57,86,52,True,True
2971,62,44,15,5,174,56,159,51,True,True
2972,62,45,13,4,184,69,171,65,True,True
2973,62,46,14,12,210,70,196,58,True,True
2974,62,47,22,13,216,84,194,71,True,True
2975,62,48,20,16,240,99,220,83,True,True
2976,63,1,2,2,24,13,22,11,True,True
2977,63,2,1,0,38,14,37,14,True,True
2978,63,3,3,1,22,20,19,19,True,True
2979,63,4,1,2,39,27,38,25,True,True
2980,63,5,2,0,25,11,23,11,True,True
2981,63,6,3,1,20,17,17,16,True,True
2982,63,7,0,1,17,25,17,24,True,True
2983,63,8,0,2,12,25,12,23,True,True
2984,63,9,0,5,15,24,15,19,True,True
2985,63,10,0,2,8,15,8,13,True,True
2986,63,11,0,2,11,19,11,17,True,True
2987,63,12,0,0,10,11,10,11,True,True
2988,63,13,1,3,10,9,9,6,True,True
2989,63,14,0,1,4,5,4,4,True,True
2990,63,15,0,3,11,12,11,9,True,True
2991,63,16,0,2,10,8,10,6,True,True
2992,63,17,1,1,4,9,3,8,True,True
2993,63,18,0,3,7,8,7,5,True,True
2994,63,19,0,0,9,1,9,1,True,True
2995,63,20,1,0,4,7,3,7,True,True
2996,63,21,2,1,13,4,11,3,True,True
2997,63,22,5,2,14,5,9,3,True,True
2998,63,23,0,0,8,6,8,6,True,True
2999,63,24,1,0,4,8,3,8,True,True
3000,63,25,1,0,4,3,3,3,True,True
3001,63,26,2,2,9,3,7,1,True,True
3002,63,27,1,1,6,2,5,1,True,True
3003,63,28,0,0,8,5,8,5,True,True
3004,63,29,1,0,8,4,7,4,True,True
3005,63,30,0,0,12,6,12,6,True,True
3006,63,31,7,2,9,8,2,6,True,True
3007,63,32,3,0,12,10,9,10,True,True
3008,63,33,4,0,10,6,6,6,True,True
3009,63,34,1,1,9,2,8,1,True,True
3010,63,35,2,0,6,5,4,5,True,True
3011,63,36,1,1,7,7,6,6,True,True
3012,63,37,1,0,8,6,7,6,True,True
3013,63,38,0,0,9,8,9,8,True,True
3014,63,39,1,1,24,10,23,9,True,True
3015,63,40,2,0,34,4,32,4,True,True
3016,63,41,1,1,18,13,17,12,True,True
3017,63,42,2,1,20,9,18,8,True,True
3018,63,43,4,1,20,7,16,6,True,True
3019,63,44,2,0,21,8,19,8,True,True
3020,63,45,2,1,26,8,24,7,True,True
3021,63,46,1,0,26,9,25,9,True,True
3022,63,47,1,0,43,14,42,14,True,True
3023,63,48,1,0,26,15,25,15,True,True
3024,64,1,0,1,20,9,20,8,True,True
3025,64,2,1,0,14,7,13,7,True,True
3026,64,3,1,0,27,9,26,9,True,True
3027,64,4,1,1,15,18,14,17,True,True
3028,64,5,0,1,12,12,12,11,True,True
3029,64,6,1,1,4,11,3,10,True,True
3030,64,7,1,0,10,8,9,8,True,True
3031,64,8,0,1,7,10,7,9,True,True
3032,64,9,0,0,0,9,0,9,False,True
3033,64,10,1,1,1,19,0,18,False,True
3034,64,11,0,0,4,4,4,4,True,True
3035,64,12,2,0,4,3,2,3,True,True
3036,64,13,0,0,5,2,5,2,True,True
3037,64,14,0,0,6,2,6,2,True,True
3038,64,15,1,0,5,5,4,5,True,True
3039,64,16,1,0,3,3,2,3,True,True
3040,64,17,0,0,1,1,1,1,True,True
3041,64,18,1,0,7,4,6,4,True,True
3042,64,19,0,0,10,2,10,2,True,True
3043,64,20,1,0,8,5,7,5,True,True
3044,64,21,2,0,3,3,1,3,True,True
3045,64,22,0,1,2,4,2,3,True,True
3046,64,23,0,0,4,4,4,4,True,True
3047,64,24,0,0,6,6,6,6,True,True
3048,64,25,0,1,7,5,7,4,True,True
3049,64,26,0,0,2,7,2,7,True,True
3050,64,27,0,1,6,9,6,8,True,True
3051,64,28,0,1,8,11,8,10,True,True
3052,64,29,0,0,11,5,11,5,True,True
3053,64,30,0,0,6,4,6,4,True,True
3054,64,31,0,0,13,4,13,4,True,True
3055,64,32,1,1,10,10,9,9,True,True
3056,64,33,0,0,11,4,11,4,True,True
3057,64,34,1,0,16,7,15,7,True,True
3058,64,35,1,1,10,8,9,7,True,True
3059,64,36,3,0,11,6,8,6,True,True
3060,64,37,1,0,17,9,16,9,True,True
3061,64,38,0,0,13,7,13,7,True,True
3062,64,39,0,0,16,10,16,10,True,True
3063,64,40,0,0,23,9,23,9,True,True
3064,64,41,0,0,22,10,22,10,True,True
3065,64,42,0,0,25,5,25,5,True,True
3066,64,43,2,0,35,3,33,3,True,True
3067,64,44,2,0,35,8,33,8,True,True
3068,64,45,1,0,38,11,37,11,True,True
3069,64,46,1,0,26,8,25,8,True,True
3070,64,47,1,1,32,10,31,9,True,True
3071,64,48,1,0,33,5,32,5,True,True
3072,65,1,370,339,728,417,358,78,True,True
3073,65,2,307,357,680,472,373,115,True,True
3074,65,3,216,323,491,483,275,160,True,True
3075,65,4,164,250,367,441,203,191,True,True
3076,65,5,116,211,294,403,178,192,True,True
3077,65,6,107,190,206,383,99,193,True,True
3078,65,7,80,156,164,364,84,208,True,True
3079,65,8,75,131,143,340,68,209,True,True
3080,65,9,62,118,127,271,65,153,True,True
3081,65,10,73,83,100,175,27,92,True,True
3082,65,11,104,78,54,118,-50,40,False,True
3083,65,12,161,56,53,72,-108,16,False,True
3084,65,13,179,59,87,52,-92,-7,False,False
3085,65,14,312,59,141,71,-171,12,False,True
3086,65,15,339,83,161,45,-178,-38,False,False
3087,65,16,463,111,232,67,-231,-44,False,False
3088,65,17,464,120,384,57,-80,-63,False,False
3089,65,18,503,139,416,94,-87,-45,False,False
3090,65,19,410,166,406,81,-4,-85,False,False
3091,65,20,361,207,414,122,53,-85,True,False
3092,65,21,284,193,357,117,73,-76,True,False
3093,65,22,305,236,294,125,-11,-111,False,False
3094,65,23,269,223,323,114,54,-109,True,False
3095,65,24,282,280,280,140,-2,-140,False,False
3096,65,25,329,269,266,152,-63,-117,False,False
3097,65,26,285,222,265,137,-20,-85,False,False
3098,65,27,271,237,245,153,-26,-84,False,False
3099,65,28,248,247,270,160,22,-87,True,False
3100,65,29,291,220,291,161,0,-59,False,False
3101,65,30,276,262,269,164,-7,-98,False,False
3102,65,31,332,248,295,191,-37,-57,False,False
3103,65,32,291,229,246,175,-45,-54,False,False
3104,65,33,272,194,237,159,-35,-35,False,False
3105,65,34,300,228,216,170,-84,-58,False,False
3106,65,35,379,243,218,176,-161,-67,False,False
3107,65,36,430,273,272,186,-158,-87,False,False
3108,65,37,486,260,312,194,-174,-66,False,False
3109,65,38,525,287,306,190,-219,-97,False,False
3110,65,39,531,278,400,217,-131,-61,False,False
3111,65,40,541,257,472,221,-69,-36,False,False
3112,65,41,476,266,511,189,35,-77,True,False
3113,65,42,431,241,564,223,133,-18,True,False
3114,65,43,492,249,680,230,188,-19,True,False
3115,65,44,500,255,769,299,269,44,True,True
3116,65,45,514,305,800,323,286,18,True,True
3117,65,46,501,267,823,311,322,44,True,True
3118,65,47,485,262,843,358,358,96,True,True
3119,65,48,448,286,812,393,364,107,True,True
3120,66,1,216,187,393,179,177,-8,True,False
3121,66,2,157,169,332,256,175,87,True,True
3122,66,3,116,190,282,208,166,18,True,True
3123,66,4,81,155,200,198,119,43,True,True
3124,66,5,55,117,115,199,60,82,True,True
3125,66,6,35,79,98,152,63,73,True,True
3126,66,7,22,70,67,138,45,68,True,True
3127,66,8,17,42,52,121,35,79,True,True
3128,66,9,8,34,48,90,40,56,True,True
3129,66,10,9,15,37,70,28,55,True,True
3130,66,11,17,13,28,43,11,30,True,True
3131,66,12,37,14,26,30,-11,16,False,True
3132,66,13,122,15,44,19,-78,4,False,True
3133,66,14,188,11,55,17,-133,6,False,True
3134,66,15,249,19,64,15,-185,-4,False,False
3135,66,16,234,27,116,37,-118,10,False,True
3136,66,17,201,20,149,37,-52,17,False,True
3137,66,18,179,38,223,52,44,14,True,True
3138,66,19,184,51,315,67,131,16,True,True
3139,66,20,189,59,358,68,169,9,True,True
3140,66,21,140,58,298,112,158,54,True,True
3141,66,22,129,70,274,92,145,22,True,True
3142,66,23,95,86,232,166,137,80,True,True
3143,66,24,116,121,241,154,125,33,True,True
3144,66,25,109,117,232,151,123,34,True,True
3145,66,26,139,145,256,174,117,29,True,True
3146,66,27,127,143,243,184,116,41,True,True
3147,66,28,147,160,223,199,76,39,True,True
3148,66,29,141,163,226,204,85,41,True,True
3149,66,30,118,134,217,170,99,36,True,True
3150,66,31,127,119,236,167,109,48,True,True
3151,66,32,95,113,195,158,100,45,True,True
3152,66,33,80,107,176,139,96,32,True,True
3153,66,34,86,93,161,118,75,25,True,True
3154,66,35,159,131,178,144,19,13,True,True
3155,66,36,173,157,228,184,55,27,True,True
3156,66,37,275,163,305,170,30,7,True,True
3157,66,38,305,135,359,174,54,39,True,True
3158,66,39,341,139,433,191,92,52,True,True
3159,66,40,302,133,484,204,182,71,True,True
3160,66,41,352,117,531,186,179,69,True,True
3161,66,42,402,120,536,196,134,76,True,True
3162,66,43,395,129,550,175,155,46,True,True
3163,66,44,421,152,530,174,109,22,True,True
3164,66,45,428,128,550,180,122,52,True,True
3165,66,46,417,131,586,211,169,80,True,True
3166,66,47,364,131,526,171,162,40,True,True
3167,66,48,297,152,481,194,184,42,True,True
3168,67,1,1,1,66,37,65,36,True,True
3169,67,2,2,1,66,37,64,36,True,True
3170,67,3,1,2,58,64,57,62,True,True
3171,67,4,2,2,55,48,53,46,True,True
3172,67,5,2,1,42,57,40,56,True,True
3173,67,6,0,1,34,70,34,69,True,True
3174,67,7,0,3,30,69,30,66,True,True
3175,67,8,2,2,24,51,22,49,True,True
3176,67,9,0,1,10,57,10,56,True,True
3177,67,10,0,5,27,41,27,36,True,True
3178,67,11,1,2,11,27,10,25,True,True
3179,67,12,0,0,11,19,11,19,True,True
3180,67,13,0,1,11,13,11,12,True,True
3181,67,14,1,0,11,9,10,9,True,True
3182,67,15,2,1,10,10,8,9,True,True
3183,67,16,0,0,8,9,8,9,True,True
3184,67,17,1,1,5,9,4,8,True,True
3185,67,18,2,1,17,11,15,10,True,True
3186,67,19,3,0,8,11,5,11,True,True
3187,67,20,3,0,9,15,6,15,True,True
3188,67,21,0,1,9,9,9,8,True,True
3189,67,22,1,1,10,14,9,13,True,True
3190,67,23,1,1,14,14,13,13,True,True
3191,67,24,3,1,5,13,2,12,True,True
3192,67,25,3,1,14,15,11,14,True,True
3193,67,26,0,2,16,10,16,8,True,True
3194,67,27,0,1,11,15,11,14,True,True
3195,67,28,0,0,6,15,6,15,True,True
3196,67,29,2,0,11,12,9,12,True,True
3197,67,30,1,1,9,6,8,5,True,True
3198,67,31,2,0,11,9,9,9,True,True
3199,67,32,3,0,13,11,10,11,True,True
3200,67,33,1,1,14,12,13,11,True,True
3201,67,34,3,2,12,11,9,9,True,True
3202,67,35,2,1,12,5,10,4,True,True
3203,67,36,3,1,16,10,13,9,True,True
3204,67,37,3,2,18,13,15,11,True,True
3205,67,38,1,2,22,15,21,13,True,True
3206,67,39,0,2,35,9,35,7,True,True
3207,67,40,1,2,31,13,30,11,True,True
3208,67,41,1,0,48,9,47,9,True,True
3209,67,42,0,1,60,13,60,12,True,True
3210,67,43,2,1,53,15,51,14,True,True
3211,67,44,0,2,63,9,63,7,True,True
3212,67,45,0,2,92,10,92,8,True,True
3213,67,46,2,0,76,20,74,20,True,True
3214,67,47,5,2,89,27,84,25,True,True
3215,67,48,1,0,102,22,101,22,True,True
3216,68,1,5188,4924,5157,4797,-31,-127,False,False
3217,68,2,4092,4936,4223,4819,131,-117,True,False
3218,68,3,3634,4531,3339,4282,-295,-249,False,False
3219,68,4,3316,4567,2621,3756,-695,-811,False,False
3220,68,5,3246,4858,2100,3514,-1146,-1344,False,False
3221,68,6,3053,4656,1786,3177,-1267,-1479,False,False
3222,68,7,2808,4228,1404,2652,-1404,-1576,False,False
3223,68,8,2225,3702,1015,2122,-1210,-1580,False,False
3224,68,9,1926,3009,856,1804,-1070,-1205,False,False
3225,68,10,1392,2156,555,1067,-837,-1089,False,False
3226,68,11,1003,1078,599,656,-404,-422,False,False
3227,68,12,1424,730,804,515,-620,-215,False,False
3228,68,13,1919,558,1218,485,-701,-73,False,False
3229,68,14,3380,697,2068,736,-1312,39,False,True
3230,68,15,4249,693,2478,723,-1771,30,False,True
3231,68,16,5230,938,3858,935,-1372,-3,False,False
3232,68,17,5767,940,4846,966,-921,26,False,True
3233,68,18,6937,1291,5939,1355,-998,64,False,True
3234,68,19,7147,1387,6433,1350,-714,-37,False,False
3235,68,20,7141,1927,6425,1867,-716,-60,False,False
3236,68,21,5904,1825,6009,2073,105,248,True,True
3237,68,22,5623,2449,5388,2497,-235,48,False,True
3238,68,23,5208,2410,5384,2604,176,194,True,True
3239,68,24,5461,2935,5593,2865,132,-70,True,False
3240,68,25,5937,2943,5855,3025,-82,82,False,True
3241,68,26,6044,3174,5841,3176,-203,2,False,True
3242,68,27,5773,3335,5605,3238,-168,-97,False,False
3243,68,28,5851,3268,5552,3208,-299,-60,False,False
3244,68,29,5496,2947,5255,2992,-241,45,False,True
3245,68,30,5397,2956,5166,2950,-231,-6,False,False
3246,68,31,5001,2822,4801,2737,-200,-85,False,False
3247,68,32,4612,2717,4576,2657,-36,-60,False,False
3248,68,33,4315,2517,3966,2528,-349,11,False,True
3249,68,34,3535,2273,3470,2229,-65,-44,False,False
3250,68,35,3918,2332,3459,2327,-459,-5,False,False
3251,68,36,4856,2838,4679,2915,-177,77,False,True
3252,68,37,6240,3103,6003,3339,-237,236,False,True
3253,68,38,7320,3261,7548,3800,228,539,True,True
3254,68,39,8135,3506,8468,3927,333,421,True,True
3255,68,40,8177,3678,8749,4039,572,361,True,True
3256,68,41,7986,3382,8639,3779,653,397,True,True
3257,68,42,7990,3601,8034,3573,44,-28,True,False
3258,68,43,8124,3689,7709,3638,-415,-51,False,False
3259,68,44,7601,3670,7239,3351,-362,-319,False,False
3260,68,45,7212,3726,6968,3349,-244,-377,False,False
3261,68,46,7226,3874,6705,3351,-521,-523,False,False
3262,68,47,7243,3880,6777,3642,-466,-238,False,False
3263,68,48,6739,3675,6884,3963,145,288,True,True
3264,69,1,4,2,99,52,95,50,True,True
3265,69,2,3,5,77,62,74,57,True,True
3266,69,3,5,2,86,68,81,66,True,True
3267,69,4,6,5,80,78,74,73,True,True
3268,69,5,6,2,80,68,74,66,True,True
3269,69,6,2,3,54,53,52,50,True,True
3270,69,7,1,4,39,58,38,54,True,True
3271,69,8,1,5,43,55,42,50,True,True
3272,69,9,5,1,44,59,39,58,True,True
3273,69,10,2,2,34,59,32,57,True,True
3274,69,11,3,2,37,56,34,54,True,True
3275,69,12,6,4,23,43,17,39,True,True
3276,69,13,5,1,22,19,17,18,True,True
3277,69,14,9,3,33,19,24,16,True,True
3278,69,15,4,2,37,23,33,21,True,True
3279,69,16,15,3,57,15,42,12,True,True
3280,69,17,7,3,69,17,62,14,True,True
3281,69,18,3,2,89,17,86,15,True,True
3282,69,19,10,1,65,23,55,22,True,True
3283,69,20,4,5,70,13,66,8,True,True
3284,69,21,4,3,42,11,38,8,True,True
3285,69,22,1,2,46,17,45,15,True,True
3286,69,23,2,4,34,17,32,13,True,True
3287,69,24,1,2,27,20,26,18,True,True
3288,69,25,3,0,45,14,42,14,True,True
3289,69,26,1,2,28,23,27,21,True,True
3290,69,27,3,4,46,29,43,25,True,True
3291,69,28,2,2,40,19,38,17,True,True
3292,69,29,0,1,35,18,35,17,True,True
3293,69,30,1,1,36,10,35,9,True,True
3294,69,31,3,1,27,16,24,15,True,True
3295,69,32,1,0,25,15,24,15,True,True
3296,69,33,5,0,25,18,20,18,True,True
3297,69,34,3,0,33,22,30,22,True,True
3298,69,35,3,3,25,16,22,13,True,True
3299,69,36,6,4,41,19,35,15,True,True
3300,69,37,6,4,38,30,32,26,True,True
3301,69,38,5,3,44,31,39,28,True,True
3302,69,39,4,4,42,26,38,22,True,True
3303,69,40,2,3,55,20,53,17,True,True
3304,69,41,2,1,67,23,65,22,True,True
3305,69,42,2,1,70,38,68,37,True,True
3306,69,43,3,5,65,39,62,34,True,True
3307,69,44,7,3,73,40,66,37,True,True
3308,69,45,5,2,93,48,88,46,True,True
3309,69,46,6,3,100,44,94,41,True,True
3310,69,47,5,1,87,65,82,64,True,True
3311,69,48,4,5,102,55,98,50,True,True
3312,70,1,31,10,135,81,104,71,True,True
3313,70,2,43,15,160,79,117,64,True,True
3314,70,3,25,10,121,67,96,57,True,True
3315,70,4,30,11,79,56,49,45,True,True
3316,70,5,18,7,69,50,51,43,True,True
3317,70,6,4,4,60,44,56,40,True,True
3318,70,7,6,10,53,41,47,31,True,True
3319,70,8,5,7,38,36,33,29,True,True
3320,70,9,5,12,35,49,30,37,True,True
3321,70,10,30,8,59,60,29,52,True,True
3322,70,11,36,20,57,34,21,14,True,True
3323,70,12,46,10,62,37,16,27,True,True
3324,70,13,54,25,79,27,25,2,True,True
3325,70,14,42,20,79,31,37,11,True,True
3326,70,15,60,19,83,35,23,16,True,True
3327,70,16,46,26,102,34,56,8,True,True
3328,70,17,61,24,87,48,26,24,True,True
3329,70,18,61,24,100,51,39,27,True,True
3330,70,19,82,21,92,49,10,28,True,True
3331,70,20,61,35,93,59,32,24,True,True
3332,70,21,46,29,107,50,61,21,True,True
3333,70,22,70,33,118,41,48,8,True,True
3334,70,23,60,24,76,44,16,20,True,True
3335,70,24,52,26,101,44,49,18,True,True
3336,70,25,54,21,111,48,57,27,True,True
3337,70,26,35,31,129,36,94,5,True,True
3338,70,27,43,22,122,52,79,30,True,True
3339,70,28,63,27,149,52,86,25,True,True
3340,70,29,73,29,136,53,63,24,True,True
3341,70,30,66,25,147,59,81,34,True,True
3342,70,31,57,24,158,49,101,25,True,True
3343,70,32,49,23,161,67,112,44,True,True
3344,70,33,36,27,150,67,114,40,True,True
3345,70,34,42,25,147,68,105,43,True,True
3346,70,35,57,32,107,54,50,22,True,True
3347,70,36,51,29,112,61,61,32,True,True
3348,70,37,61,31,129,48,68,17,True,True
3349,70,38,40,24,139,53,99,29,True,True
3350,70,39,61,34,143,65,82,31,True,True
3351,70,40,61,21,153,45,92,24,True,True
3352,70,41,59,19,175,58,116,39,True,True
3353,70,42,79,27,132,69,53,42,True,True
3354,70,43,61,30,141,55,80,25,True,True
3355,70,44,43,16,144,68,101,52,True,True
3356,70,45,49,27,157,46,108,19,True,True
3357,70,46,38,25,169,63,131,38,True,True
3358,70,47,53,33,172,56,119,23,True,True
3359,70,48,61,31,120,72,59,41,True,True
3360,71,1,0,1,36,23,36,22,True,True
3361,71,2,1,1,45,30,44,29,True,True
3362,71,3,3,2,65,42,62,40,True,True
3363,71,4,2,1,42,50,40,49,True,True
3364,71,5,0,0,34,54,34,54,True,True
3365,71,6,2,2,31,34,29,32,True,True
3366,71,7,4,3,32,42,28,39,True,True
3367,71,8,0,2,17,34,17,32,True,True
3368,71,9,0,0,19,34,19,34,True,True
3369,71,10,1,3,11,34,10,31,True,True
3370,71,11,2,0,12,14,10,14,True,True
3371,71,12,0,2,15,18,15,16,True,True
3372,71,13,3,1,13,11,10,10,True,True
3373,71,14,3,1,10,13,7,12,True,True
3374,71,15,1,0,21,6,20,6,True,True
3375,71,16,1,1,20,9,19,8,True,True
3376,71,17,1,2,12,6,11,4,True,True
3377,71,18,0,0,8,9,8,9,True,True
3378,71,19,1,0,18,13,17,13,True,True
3379,71,20,1,1,10,10,9,9,True,True
3380,71,21,3,0,11,5,8,5,True,True
3381,71,22,2,0,9,5,7,5,True,True
3382,71,23,4,1,11,5,7,4,True,True
3383,71,24,1,1,14,4,13,3,True,True
3384,71,25,1,0,12,8,11,8,True,True
3385,71,26,1,0,14,9,13,9,True,True
3386,71,27,2,1,20,3,18,2,True,True
3387,71,28,1,0,14,8,13,8,True,True
3388,71,29,1,0,15,6,14,6,True,True
3389,71,30,1,0,11,5,10,5,True,True
3390,71,31,4,0,21,7,17,7,True,True
3391,71,32,0,1,16,6,16,5,True,True
3392,71,33,1,1,21,12,20,11,True,True
3393,71,34,2,2,8,9,6,7,True,True
3394,71,35,1,0,16,5,15,5,True,True
3395,71,36,0,0,11,8,11,8,True,True
3396,71,37,0,0,10,7,10,7,True,True
3397,71,38,0,0,13,10,13,10,True,True
3398,71,39,2,1,25,10,23,9,True,True
3399,71,40,0,0,18,13,18,13,True,True
3400,71,41,1,1,19,13,18,12,True,True
3401,71,42,1,1,25,8,24,7,True,True
3402,71,43,1,0,25,11,24,11,True,True
3403,71,44,2,0,42,12,40,12,True,True
3404,71,45,0,0,45,18,45,18,True,True
3405,71,46,1,2,31,23,30,21,True,True
3406,71,47,1,1,36,22,35,21,True,True
3407,71,48,1,2,58,21,57,19,True,True
3408,72,1,1,3,44,20,43,17,True,True
3409,72,2,3,1,51,19,48,18,True,True
3410,72,3,1,0,64,34,63,34,True,True
3411,72,4,0,5,44,30,44,25,True,True
3412,72,5,3,0,35,18,32,18,True,True
3413,72,6,1,1,16,24,15,23,True,True
3414,72,7,0,0,13,19,13,19,True,True
3415,72,8,0,2,15,31,15,29,True,True
3416,72,9,1,2,16,19,15,17,True,True
3417,72,10,2,2,15,35,13,33,True,True
3418,72,11,0,3,13,33,13,30,True,True
3419,72,12,4,3,17,19,13,16,True,True
3420,72,13,0,2,12,12,12,10,True,True
3421,72,14,3,1,9,6,6,5,True,True
3422,72,15,4,1,9,12,5,11,True,True
3423,72,16,3,0,20,12,17,12,True,True
3424,72,17,4,3,16,9,12,6,True,True
3425,72,18,1,3,16,7,15,4,True,True
3426,72,19,2,5,14,10,12,5,True,True
3427,72,20,0,1,13,6,13,5,True,True
3428,72,21,2,2,17,7,15,5,True,True
3429,72,22,1,0,15,5,14,5,True,True
3430,72,23,3,1,11,5,8,4,True,True
3431,72,24,1,1,16,7,15,6,True,True
3432,72,25,1,0,15,3,14,3,True,True
3433,72,26,2,0,15,7,13,7,True,True
3434,72,27,0,1,12,5,12,4,True,True
3435,72,28,2,0,19,3,17,3,True,True
3436,72,29,2,2,12,10,10,8,True,True
3437,72,30,0,3,18,10,18,7,True,True
3438,72,31,0,0,15,7,15,7,True,True
3439,72,32,1,0,17,4,16,4,True,True
3440,72,33,2,1,19,8,17,7,True,True
3441,72,34,4,0,15,10,11,10,True,True
3442,72,35,2,0,20,2,18,2,True,True
3443,72,36,0,1,12,8,12,7,True,True
3444,72,37,1,0,19,7,18,7,True,True
3445,72,38,1,0,17,11,16,11,True,True
3446,72,39,2,2,16,15,14,13,True,True
3447,72,40,1,0,12,9,11,9,True,True
3448,72,41,3,2,30,13,27,11,True,True
3449,72,42,4,1,32,12,28,11,True,True
3450,72,43,1,3,36,9,35,6,True,True
3451,72,44,1,1,31,18,30,17,True,True
3452,72,45,2,3,48,19,46,16,True,True
3453,72,46,3,1,43,20,40,19,True,True
3454,72,47,2,2,42,17,40,15,True,True
3455,72,48,4,2,43,19,39,17,True,True
3456,73,1,3,0,41,11,38,11,True,True
3457,73,2,2,1,18,15,16,14,True,True
3458,73,3,2,0,14,11,12,11,True,True
3459,73,4,0,1,19,10,19,9,True,True
3460,73,5,0,0,15,8,15,8,True,True
3461,73,6,0,0,11,11,11,11,True,True
3462,73,7,0,1,5,20,5,19,True,True
3463,73,8,1,1,4,14,3,13,True,True
3464,73,9,0,0,7,19,7,19,True,True
3465,73,10,0,0,5,7,5,7,True,True
3466,73,11,0,0,6,12,6,12,True,True
3467,73,12,0,1,7,6,7,5,True,True
3468,73,13,0,0,2,8,2,8,True,True
3469,73,14,1,0,6,5,5,5,True,True
3470,73,15,0,0,1,8,1,8,True,True
3471,73,16,0,0,5,4,5,4,True,True
3472,73,17,1,0,5,5,4,5,True,True
3473,73,18,1,0,7,4,6,4,True,True
3474,73,19,1,0,11,8,10,8,True,True
3475,73,20,0,2,7,7,7,5,True,True
3476,73,21,1,0,7,7,6,7,True,True
3477,73,22,0,0,10,6,10,6,True,True
3478,73,23,1,1,3,5,2,4,True,True
3479,73,24,0,1,3,4,3,3,True,True
3480,73,25,0,0,8,3,8,3,True,True
3481,73,26,0,3,5,6,5,3,True,True
3482,73,27,0,0,8,5,8,5,True,True
3483,73,28,0,0,5,3,5,3,True,True
3484,73,29,0,0,11,7,11,7,True,True
3485,73,30,0,0,6,7,6,7,True,True
3486,73,31,0,1,7,5,7,4,True,True
3487,73,32,0,1,3,2,3,1,True,True
3488,73,33,1,1,9,6,8,5,True,True
3489,73,34,4,0,13,2,9,2,True,True
3490,73,35,1,0,9,6,8,6,True,True
3491,73,36,1,0,12,5,11,5,True,True
3492,73,37,0,0,6,6,6,6,True,True
3493,73,38,0,1,8,4,8,3,True,True
3494,73,39,0,0,11,14,11,14,True,True
3495,73,40,0,1,10,2,10,1,True,True
3496,73,41,1,0,9,1,8,1,True,True
3497,73,42,2,0,22,5,20,5,True,True
3498,73,43,2,0,22,6,20,6,True,True
3499,73,44,2,1,34,4,32,3,True,True
3500,73,45,1,0,22,3,21,3,True,True
3501,73,46,3,0,24,5,21,5,True,True
3502,73,47,1,1,28,11,27,10,True,True
3503,73,48,2,0,24,5,22,5,True,True
3504,74,1,600,454,1491,968,891,514,True,True
3505,74,2,551,418,1240,924,689,506,True,True
3506,74,3,322,358,1061,935,739,577,True,True
3507,74,4,261,355,855,916,594,561,True,True
3508,74,5,223,276,710,889,487,613,True,True
3509,74,6,178,208,628,821,450,613,True,True
3510,74,7,139,211,489,747,350,536,True,True
3511,74,8,147,191,451,702,304,511,True,True
3512,74,9,171,195,464,729,293,534,True,True
3513,74,10,230,202,403,658,173,456,True,True
3514,74,11,224,188,324,461,100,273,True,True
3515,74,12,430,180,384,312,-46,132,False,True
3516,74,13,540,186,733,251,193,65,True,True
3517,74,14,925,294,1260,261,335,-33,True,False
3518,74,15,985,277,1682,299,697,22,True,True
3519,74,16,1350,411,1936,477,586,66,True,True
3520,74,17,1083,301,1588,511,505,210,True,True
3521,74,18,1044,493,1164,598,120,105,True,True
3522,74,19,718,421,979,661,261,240,True,True
3523,74,20,623,527,842,845,219,318,True,True
3524,74,21,534,482,875,829,341,347,True,True
3525,74,22,558,593,876,920,318,327,True,True
3526,74,23,520,480,899,841,379,361,True,True
3527,74,24,610,542,1018,957,408,415,True,True
3528,74,25,513,499,909,814,396,315,True,True
3529,74,26,564,496,948,897,384,401,True,True
3530,74,27,563,456,1021,796,458,340,True,True
3531,74,28,616,534,1079,821,463,287,True,True
3532,74,29,576,501,1135,846,559,345,True,True
3533,74,30,667,533,1216,855,549,322,True,True
3534,74,31,646,500,1274,788,628,288,True,True
3535,74,32,602,524,1228,850,626,326,True,True
3536,74,33,567,428,1150,795,583,367,True,True
3537,74,34,584,488,1173,699,589,211,True,True
3538,74,35,826,463,1307,671,481,208,True,True
3539,74,36,1122,583,1607,668,485,85,True,True
3540,74,37,1125,495,1777,657,652,162,True,True
3541,74,38,1024,541,1729,686,705,145,True,True
3542,74,39,932,512,1676,617,744,105,True,True
3543,74,40,816,491,1729,552,913,61,True,True
3544,74,41,758,401,1755,608,997,207,True,True
3545,74,42,794,463,1622,601,828,138,True,True
3546,74,43,766,443,1798,632,1032,189,True,True
3547,74,44,822,508,1799,651,977,143,True,True
3548,74,45,741,451,1772,695,1031,244,True,True
3549,74,46,704,503,1681,734,977,231,True,True
3550,74,47,597,562,1726,769,1129,207,True,True
3551,74,48,548,561,1654,802,1106,241,True,True
3552,75,1,848,735,2068,1240,1220,505,True,True
3553,75,2,661,555,1834,1360,1173,805,True,True
3554,75,3,446,518,1420,1285,974,767,True,True
3555,75,4,379,396,1120,1232,741,836,True,True
3556,75,5,306,347,895,1186,589,839,True,True
3557,75,6,253,276,821,1176,568,900,True,True
3558,75,7,213,247,643,1121,430,874,True,True
3559,75,8,214,225,547,1027,333,802,True,True
3560,75,9,266,240,538,1000,272,760,True,True
3561,75,10,315,235,438,774,123,539,True,True
3562,75,11,416,245,411,511,-5,266,False,True
3563,75,12,735,266,667,358,-68,92,False,True
3564,75,13,889,323,994,317,105,-6,True,False
3565,75,14,1416,395,2037,587,621,192,True,True
3566,75,15,1765,460,2413,474,648,14,True,True
3567,75,16,2214,635,3049,610,835,-25,True,False
3568,75,17,2211,690,2783,644,572,-46,True,False
3569,75,18,1959,830,2579,782,620,-48,True,False
3570,75,19,1783,815,2391,626,608,-189,True,False
3571,75,20,1678,984,2178,653,500,-331,True,False
3572,75,21,1606,944,1988,718,382,-226,True,False
3573,75,22,1693,988,2034,715,341,-273,True,False
3574,75,23,1787,893,2100,698,313,-195,True,False
3575,75,24,1866,931,2000,740,134,-191,True,False
3576,75,25,1820,876,2217,858,397,-18,True,False
3577,75,26,1652,836,2108,801,456,-35,True,False
3578,75,27,1650,820,2002,894,352,74,True,True
3579,75,28,1762,851,2075,892,313,41,True,True
3580,75,29,1800,790,2046,931,246,141,True,True
3581,75,30,1901,826,2188,919,287,93,True,True
3582,75,31,1947,822,2194,897,247,75,True,True
3583,75,32,1782,835,1952,865,170,30,True,True
3584,75,33,1631,802,1822,880,191,78,True,True
3585,75,34,1675,691,1623,849,-52,158,False,True
3586,75,35,2082,709,1746,831,-336,122,False,True
3587,75,36,2433,853,2269,874,-164,21,False,True
3588,75,37,2365,762,2426,934,61,172,True,True
3589,75,38,2243,826,2529,985,286,159,True,True
3590,75,39,2083,773,2327,952,244,179,True,True
3591,75,40,1955,701,2260,854,305,153,True,True
3592,75,41,1757,712,2343,887,586,175,True,True
3593,75,42,1628,726,2373,846,745,120,True,True
3594,75,43,1637,724,2639,987,1002,263,True,True
3595,75,44,1431,697,2568,1032,1137,335,True,True
3596,75,45,1376,670,2659,1041,1283,371,True,True
3597,75,46,1254,729,2547,1105,1293,376,True,True
3598,75,47,1179,749,2550,1125,1371,376,True,True
3599,75,48,970,655,2386,1198,1416,543,True,True
3600,76,1,3,1,55,20,52,19,True,True
3601,76,2,2,1,60,21,58,20,True,True
3602,76,3,3,5,62,35,59,30,True,True
3603,76,4,2,2,56,32,54,30,True,True
3604,76,5,3,3,42,42,39,39,True,True
3605,76,6,5,9,35,54,30,45,True,True
3606,76,7,5,4,33,39,28,35,True,True
3607,76,8,5,3,23,45,18,42,True,True
3608,76,9,3,3,14,36,11,33,True,True
3609,76,10,1,3,24,35,23,32,True,True
3610,76,11,2,3,14,37,12,34,True,True
3611,76,12,3,1,14,21,11,20,True,True
3612,76,13,0,5,8,22,8,17,True,True
3613,76,14,5,2,13,7,8,5,True,True
3614,76,15,3,3,21,16,18,13,True,True
3615,76,16,3,1,13,14,10,13,True,True
3616,76,17,3,2,19,9,16,7,True,True
3617,76,18,5,2,17,13,12,11,True,True
3618,76,19,4,2,20,14,16,12,True,True
3619,76,20,6,7,17,15,11,8,True,True
3620,76,21,7,1,21,14,14,13,True,True
3621,76,22,6,4,29,11,23,7,True,True
3622,76,23,5,6,18,10,13,4,True,True
3623,76,24,1,4,14,17,13,13,True,True
3624,76,25,1,6,24,14,23,8,True,True
3625,76,26,3,5,14,13,11,8,True,True
3626,76,27,1,3,21,13,20,10,True,True
3627,76,28,1,0,13,15,12,15,True,True
3628,76,29,2,1,26,13,24,12,True,True
3629,76,30,2,2,24,13,22,11,True,True
3630,76,31,2,2,28,12,26,10,True,True
3631,76,32,0,2,17,14,17,12,True,True
3632,76,33,1,3,22,16,21,13,True,True
3633,76,34,2,3,30,13,28,10,True,True
3634,76,35,4,4,22,15,18,11,True,True
3635,76,36,6,3,13,16,7,13,True,True
3636,76,37,3,4,24,12,21,8,True,True
3637,76,38,2,0,23,12,21,12,True,True
3638,76,39,1,1,24,17,23,16,True,True
3639,76,40,3,0,29,10,26,10,True,True
3640,76,41,1,2,42,21,41,19,True,True
3641,76,42,6,0,35,21,29,21,True,True
3642,76,43,2,1,29,19,27,18,True,True
3643,76,44,3,2,42,13,39,11,True,True
3644,76,45,1,1,30,18,29,17,True,True
3645,76,46,1,2,38,33,37,31,True,True
3646,76,47,3,2,46,22,43,20,True,True
3647,76,48,2,1,50,31,48,30,True,True
3648,77,1,2,0,21,12,19,12,True,True
3649,77,2,0,0,13,10,13,10,True,True
3650,77,3,0,0,15,8,15,8,True,True
3651,77,4,1,2,17,7,16,5,True,True
3652,77,5,0,1,14,12,14,11,True,True
3653,77,6,1,1,9,12,8,11,True,True
3654,77,7,0,2,10,9,10,7,True,True
3655,77,8,0,4,10,17,10,13,True,True
3656,77,9,2,1,6,20,4,19,True,True
3657,77,10,0,1,8,21,8,20,True,True
3658,77,11,1,0,8,15,7,15,True,True
3659,77,12,0,0,3,5,3,5,True,True
3660,77,13,1,0,7,2,6,2,True,True
3661,77,14,1,0,3,6,2,6,True,True
3662,77,15,0,2,4,3,4,1,True,True
3663,77,16,0,0,3,2,3,2,True,True
3664,77,17,0,0,5,2,5,2,True,True
3665,77,18,1,0,4,0,3,0,True,False
3666,77,19,0,0,4,2,4,2,True,True
3667,77,20,0,0,5,3,5,3,True,True
3668,77,21,0,0,2,3,2,3,True,True
3669,77,22,0,0,10,1,10,1,True,True
3670,77,23,0,0,4,3,4,3,True,True
3671,77,24,0,0,8,1,8,1,True,True
3672,77,25,2,1,6,3,4,2,True,True
3673,77,26,1,2,4,0,3,-2,True,False
3674,77,27,1,0,7,4,6,4,True,True
3675,77,28,2,0,7,5,5,5,True,True
3676,77,29,3,0,7,1,4,1,True,True
3677,77,30,1,0,8,2,7,2,True,True
3678,77,31,1,0,8,4,7,4,True,True
3679,77,32,4,1,8,2,4,1,True,True
3680,77,33,0,0,6,6,6,6,True,True
3681,77,34,0,0,6,2,6,2,True,True
3682,77,35,0,1,7,3,7,2,True,True
3683,77,36,0,0,3,1,3,1,True,True
3684,77,37,0,0,3,0,3,0,True,False
3685,77,38,0,0,2,2,2,2,True,True
3686,77,39,0,0,9,4,9,4,True,True
3687,77,40,0,0,5,2,5,2,True,True
3688,77,41,0,0,9,3,9,3,True,True
3689,77,42,1,0,14,2,13,2,True,True
3690,77,43,0,1,8,6,8,5,True,True
3691,77,44,0,0,10,4,10,4,True,True
3692,77,45,0,1,14,7,14,6,True,True
3693,77,46,0,0,11,9,11,9,True,True
3694,77,47,0,0,16,5,16,5,True,True
3695,77,48,0,1,16,4,16,3,True,True
3696,78,1,1,2,27,12,26,10,True,True
3697,78,2,1,2,27,13,26,11,True,True
3698,78,3,3,0,20,26,17,26,True,True
3699,78,4,0,1,16,10,16,9,True,True
3700,78,5,0,2,14,16,14,14,True,True
3701,78,6,0,4,14,23,14,19,True,True
3702,78,7,1,2,8,16,7,14,True,True
3703,78,8,0,3,6,20,6,17,True,True
3704,78,9,1,2,9,17,8,15,True,True
3705,78,10,0,0,11,19,11,19,True,True
3706,78,11,1,4,11,19,10,15,True,True
3707,78,12,0,3,2,12,2,9,True,True
3708,78,13,3,0,5,7,2,7,True,True
3709,78,14,4,1,8,3,4,2,True,True
3710,78,15,4,2,12,4,8,2,True,True
3711,78,16,5,1,16,3,11,2,True,True
3712,78,17,2,0,11,3,9,3,True,True
3713,78,18,3,0,18,3,15,3,True,True
3714,78,19,0,0,10,5,10,5,True,True
3715,78,20,0,0,3,3,3,3,True,True
3716,78,21,1,1,8,5,7,4,True,True
3717,78,22,0,0,7,7,7,7,True,True
3718,78,23,1,0,8,2,7,2,True,True
3719,78,24,3,2,12,1,9,-1,True,False
3720,78,25,1,2,6,3,5,1,True,True
3721,78,26,0,0,8,3,8,3,True,True
3722,78,27,3,0,6,6,3,6,True,True
3723,78,28,1,0,12,4,11,4,True,True
3724,78,29,2,0,4,7,2,7,True,True
3725,78,30,0,0,6,4,6,4,True,True
3726,78,31,1,0,10,2,9,2,True,True
3727,78,32,0,0,5,5,5,5,True,True
3728,78,33,1,0,5,5,4,5,True,True
3729,78,34,0,0,7,9,7,9,True,True
3730,78,35,1,0,3,8,2,8,True,True
3731,78,36,0,0,1,7,1,7,True,True
3732,78,37,2,0,7,3,5,3,True,True
3733,78,38,0,0,8,8,8,8,True,True
3734,78,39,1,0,14,4,13,4,True,True
3735,78,40,1,2,15,10,14,8,True,True
3736,78,41,0,0,6,7,6,7,True,True
3737,78,42,0,0,12,13,12,13,True,True
3738,78,43,0,0,11,4,11,4,True,True
3739,78,44,1,1,12,8,11,7,True,True
3740,78,45,3,1,12,12,9,11,True,True
3741,78,46,3,1,28,17,25,16,True,True
3742,78,47,5,0,12,13,7,13,True,True
3743,78,48,5,0,29,15,24,15,True,True
3744,79,1,9431,9627,7053,7771,-2378,-1856,False,False
3745,79,2,8225,10048,5962,8116,-2263,-1932,False,False
3746,79,3,6661,10314,4701,7325,-1960,-2989,False,False
3747,79,4,5440,10799,3606,6853,-1834,-3946,False,False
3748,79,5,4432,11260,2919,6083,-1513,-5177,False,False
3749,79,6,3544,10853,2358,5236,-1186,-5617,False,False
3750,79,7,3062,9479,1851,4352,-1211,-5127,False,False
3751,79,8,2565,7896,1324,3331,-1241,-4565,False,False
3752,79,9,2700,6337,1131,2634,-1569,-3703,False,False
3753,79,10,1794,3516,782,1599,-1012,-1917,False,False
3754,79,11,1608,2108,527,908,-1081,-1200,False,False
3755,79,12,2033,1326,539,600,-1494,-726,False,False
3756,79,13,2590,951,653,395,-1937,-556,False,False
3757,79,14,4214,1003,898,344,-3316,-659,False,False
3758,79,15,4789,1015,1135,376,-3654,-639,False,False
3759,79,16,4852,1156,1592,474,-3260,-682,False,False
3760,79,17,4487,1258,1802,519,-2685,-739,False,False
3761,79,18,3471,1591,1637,714,-1834,-877,False,False
3762,79,19,4336,1790,1739,919,-2597,-871,False,False
3763,79,20,5165,2274,1796,1289,-3369,-985,False,False
3764,79,21,5173,2373,2123,1461,-3050,-912,False,False
3765,79,22,4520,2913,2145,1797,-2375,-1116,False,False
3766,79,23,3875,2808,2426,2291,-1449,-517,False,False
3767,79,24,3971,3059,2703,2410,-1268,-649,False,False
3768,79,25,3517,3049,2874,2853,-643,-196,False,False
3769,79,26,3811,3216,3070,2869,-741,-347,False,False
3770,79,27,3657,3142,3089,2946,-568,-196,False,False
3771,79,28,4003,3433,3078,2780,-925,-653,False,False
3772,79,29,4110,3292,3235,2894,-875,-398,False,False
3773,79,30,4176,3228,3273,2740,-903,-488,False,False
3774,79,31,3807,3072,3272,2621,-535,-451,False,False
3775,79,32,3636,3046,3274,2536,-362,-510,False,False
3776,79,33,3169,2737,3115,2448,-54,-289,False,False
3777,79,34,3250,2672,3031,2332,-219,-340,False,False
3778,79,35,4180,2994,3541,2759,-639,-235,False,False
3779,79,36,4807,3301,5027,3338,220,37,True,True
3780,79,37,5837,3267,6742,3917,905,650,True,True
3781,79,38,6847,3643,8868,4394,2021,751,True,True
3782,79,39,7522,3872,11050,4894,3528,1022,True,True
3783,79,40,8198,3903,12515,5352,4317,1449,True,True
3784,79,41,8430,4016,12499,5648,4069,1632,True,True
3785,79,42,9453,4319,12465,5395,3012,1076,True,True
3786,79,43,10553,4660,12112,5287,1559,627,True,True
3787,79,44,11669,5074,11448,5340,-221,266,False,True
3788,79,45,12558,5571,11002,5195,-1556,-376,False,False
3789,79,46,12813,5946,10669,5529,-2144,-417,False,False
3790,79,47,13134,6130,10498,5531,-2636,-599,False,False
3791,79,48,12972,6429,10151,5849,-2821,-580,False,False
3792,80,1,637,739,1632,808,995,69,True,True
3793,80,2,709,892,1608,1052,899,160,True,True
3794,80,3,619,1077,1456,1156,837,79,True,True
3795,80,4,534,1023,1139,1227,605,204,True,True
3796,80,5,498,1130,938,1195,440,65,True,True
3797,80,6,399,987,757,1195,358,208,True,True
3798,80,7,379,888,601,1040,222,152,True,True
3799,80,8,355,822,481,876,126,54,True,True
3800,80,9,285,674,437,801,152,127,True,True
3801,80,10,143,354,313,618,170,264,True,True
3802,80,11,63,196,199,369,136,173,True,True
3803,80,12,41,106,155,263,114,157,True,True
3804,80,13,18,65,100,136,82,71,True,True
3805,80,14,32,43,71,109,39,66,True,True
3806,80,15,16,31,86,59,70,28,True,True
3807,80,16,17,28,76,67,59,39,True,True
3808,80,17,30,27,102,55,72,28,True,True
3809,80,18,22,36,70,63,48,27,True,True
3810,80,19,28,23,78,68,50,45,True,True
3811,80,20,23,28,81,59,58,31,True,True
3812,80,21,22,35,93,72,71,37,True,True
3813,80,22,26,28,95,85,69,57,True,True
3814,80,23,23,37,95,81,72,44,True,True
3815,80,24,30,41,117,112,87,71,True,True
3816,80,25,23,37,114,90,91,53,True,True
3817,80,26,31,46,134,129,103,83,True,True
3818,80,27,25,53,136,103,111,50,True,True
3819,80,28,21,66,152,146,131,80,True,True
3820,80,29,33,71,136,156,103,85,True,True
3821,80,30,29,82,155,158,126,76,True,True
3822,80,31,30,51,153,136,123,85,True,True
3823,80,32,34,48,176,127,142,79,True,True
3824,80,33,23,58,165,142,142,84,True,True
3825,80,34,32,66,129,170,97,104,True,True
3826,80,35,39,54,171,151,132,97,True,True
3827,80,36,49,84,252,222,203,138,True,True
3828,80,37,70,82,325,214,255,132,True,True
3829,80,38,96,100,378,248,282,148,True,True
3830,80,39,141,142,475,290,334,148,True,True
3831,80,40,155,152,540,279,385,127,True,True
3832,80,41,187,140,642,321,455,181,True,True
3833,80,42,241,140,771,316,530,176,True,True
3834,80,43,304,173,906,362,602,189,True,True
3835,80,44,388,210,1092,429,704,219,True,True
3836,80,45,417,249,1222,473,805,224,True,True
3837,80,46,499,334,1344,489,845,155,True,True
3838,80,47,649,399,1461,600,812,201,True,True
3839,80,48,727,448,1706,664,979,216,True,True
3840,81,1,0,0,13,8,13,8,True,True
3841,81,2,0,0,11,3,11,3,True,True
3842,81,3,0,1,10,6,10,5,True,True
3843,81,4,0,0,8,7,8,7,True,True
3844,81,5,1,0,2,9,1,9,True,True
3845,81,6,0,0,6,9,6,9,True,True
3846,81,7,0,0,5,9,5,9,True,True
3847,81,8,0,0,4,7,4,7,True,True
3848,81,9,0,1,5,13,5,12,True,True
3849,81,10,0,1,4,10,4,9,True,True
3850,81,11,0,0,3,4,3,4,True,True
3851,81,12,1,0,2,4,1,4,True,True
3852,81,13,0,0,1,2,1,2,True,True
3853,81,14,0,0,5,3,5,3,True,True
3854,81,15,0,1,3,1,3,0,True,False
3855,81,16,0,0,4,1,4,1,True,True
3856,81,17,0,0,5,2,5,2,True,True
3857,81,18,0,0,3,2,3,2,True,True
3858,81,19,1,1,3,2,2,1,True,True
3859,81,20,1,0,2,3,1,3,True,True
3860,81,21,0,0,1,3,1,3,True,True
3861,81,22,0,0,4,2,4,2,True,True
3862,81,23,0,0,5,2,5,2,True,True
3863,81,24,0,0,6,4,6,4,True,True
3864,81,25,0,0,2,1,2,1,True,True
3865,81,26,0,0,4,7,4,7,True,True
3866,81,27,0,0,1,1,1,1,True,True
3867,81,28,0,0,5,3,5,3,True,True
3868,81,29,0,0,3,2,3,2,True,True
3869,81,30,0,0,5,1,5,1,True,True
3870,81,31,0,0,3,2,3,2,True,True
3871,81,32,0,0,5,2,5,2,True,True
3872,81,33,0,0,5,0,5,0,True,False
3873,81,34,0,0,3,1,3,1,True,True
3874,81,35,0,0,2,3,2,3,True,True
3875,81,36,0,0,6,1,6,1,True,True
3876,81,37,0,0,7,6,7,6,True,True
3877,81,38,0,0,9,2,9,2,True,True
3878,81,39,0,1,6,0,6,-1,True,False
3879,81,40,0,0,8,4,8,4,True,True
3880,81,41,0,0,11,4,11,4,True,True
3881,81,42,0,0,9,0,9,0,True,False
3882,81,43,0,0,8,4,8,4,True,True
3883,81,44,2,0,15,4,13,4,True,True
3884,81,45,0,0,13,7,13,7,True,True
3885,81,46,2,0,15,2,13,2,True,True
3886,81,47,0,0,16,2,16,2,True,True
3887,81,48,1,0,20,3,19,3,True,True
3888,82,1,73,49,458,176,385,127,True,True
3889,82,2,73,69,460,262,387,193,True,True
3890,82,3,95,50,441,298,346,248,True,True
3891,82,4,78,56,412,318,334,262,True,True
3892,82,5,82,65,302,304,220,239,True,True
3893,82,6,77,59,265,277,188,218,True,True
3894,82,7,56,64,210,291,154,227,True,True
3895,82,8,55,73,148,271,93,198,True,True
3896,82,9,64,71,147,229,83,158,True,True
3897,82,10,62,64,124,223,62,159,True,True
3898,82,11,69,61,118,169,49,108,True,True
3899,82,12,80,62,82,114,2,52,True,True
3900,82,13,71,53,70,89,-1,36,False,True
3901,82,14,96,50,100,81,4,31,True,True
3902,82,15,73,53,94,75,21,22,True,True
3903,82,16,105,52,81,75,-24,23,False,True
3904,82,17,78,66,84,60,6,-6,True,False
3905,82,18,75,59,77,71,2,12,True,True
3906,82,19,51,60,85,75,34,15,True,True
3907,82,20,53,58,57,63,4,5,True,True
3908,82,21,39,36,77,67,38,31,True,True
3909,82,22,40,39,86,65,46,26,True,True
3910,82,23,22,26,62,63,40,37,True,True
3911,82,24,21,30,71,52,50,22,True,True
3912,82,25,29,41,77,73,48,32,True,True
3913,82,26,24,32,95,74,71,42,True,True
3914,82,27,19,21,75,58,56,37,True,True
3915,82,28,28,29,74,43,46,14,True,True
3916,82,29,23,17,72,50,49,33,True,True
3917,82,30,36,17,92,52,56,35,True,True
3918,82,31,43,19,88,65,45,46,True,True
3919,82,32,33,15,57,42,24,27,True,True
3920,82,33,16,21,62,49,46,28,True,True
3921,82,34,25,17,80,49,55,32,True,True
3922,82,35,28,24,67,58,39,34,True,True
3923,82,36,22,16,65,48,43,32,True,True
3924,82,37,23,20,76,49,53,29,True,True
3925,82,38,19,19,79,58,60,39,True,True
3926,82,39,24,17,94,64,70,47,True,True
3927,82,40,15,19,82,58,67,39,True,True
3928,82,41,23,19,111,57,88,38,True,True
3929,82,42,23,16,122,55,99,39,True,True
3930,82,43,23,16,123,55,100,39,True,True
3931,82,44,29,25,169,79,140,54,True,True
3932,82,45,35,18,210,86,175,68,True,True
3933,82,46,39,15,274,90,235,75,True,True
3934,82,47,48,29,309,119,261,90,True,True
3935,82,48,67,32,369,152,302,120,True,True
3936,83,1,36,29,251,124,215,95,True,True
3937,83,2,38,33,310,210,272,177,True,True
3938,83,3,38,44,269,197,231,153,True,True
3939,83,4,41,41,238,228,197,187,True,True
3940,83,5,25,46,181,212,156,166,True,True
3941,83,6,31,36,140,178,109,142,True,True
3942,83,7,33,47,136,163,103,116,True,True
3943,83,8,32,32,108,172,76,140,True,True
3944,83,9,25,41,106,144,81,103,True,True
3945,83,10,35,35,69,131,34,96,True,True
3946,83,11,34,26,53,110,19,84,True,True
3947,83,12,53,30,52,74,-1,44,False,True
3948,83,13,55,23,47,49,-8,26,False,True
3949,83,14,75,30,34,30,-41,0,False,False
3950,83,15,45,15,39,21,-6,6,False,True
3951,83,16,49,15,55,19,6,4,True,True
3952,83,17,42,19,38,30,-4,11,False,True
3953,83,18,44,28,46,37,2,9,True,True
3954,83,19,36,28,52,47,16,19,True,True
3955,83,20,31,28,38,29,7,1,True,True
3956,83,21,21,20,34,31,13,11,True,True
3957,83,22,30,25,44,36,14,11,True,True
3958,83,23,24,18,31,33,7,15,True,True
3959,83,24,22,22,44,32,22,10,True,True
3960,83,25,18,10,32,32,14,22,True,True
3961,83,26,15,13,41,36,26,23,True,True
3962,83,27,18,12,44,21,26,9,True,True
3963,83,28,16,11,32,28,16,17,True,True
3964,83,29,14,19,39,35,25,16,True,True
3965,83,30,11,12,61,21,50,9,True,True
3966,83,31,17,12,40,27,23,15,True,True
3967,83,32,21,11,39,42,18,31,True,True
3968,83,33,20,16,45,41,25,25,True,True
3969,83,34,16,10,55,23,39,13,True,True
3970,83,35,20,20,62,39,42,19,True,True
3971,83,36,21,9,63,43,42,34,True,True
3972,83,37,14,8,62,42,48,34,True,True
3973,83,38,13,11,72,38,59,27,True,True
3974,83,39,16,5,69,38,53,33,True,True
3975,83,40,22,11,85,50,63,39,True,True
3976,83,41,9,15,81,38,72,23,True,True
3977,83,42,16,5,71,34,55,29,True,True
3978,83,43,13,13,91,50,78,37,True,True
3979,83,44,23,17,123,54,100,37,True,True
3980,83,45,14,20,143,57,129,37,True,True
3981,83,46,19,17,157,55,138,38,True,True
3982,83,47,28,27,222,93,194,66,True,True
3983,83,48,30,23,278,110,248,87,True,True
3984,84,1,0,0,2,1,2,1,True,True
3985,84,2,0,1,3,2,3,1,True,True
3986,84,3,0,2,1,4,1,2,True,True
3987,84,4,0,2,2,2,2,0,True,False
3988,84,5,0,1,0,2,0,1,False,True
3989,84,6,0,1,0,4,0,3,False,True
3990,84,7,1,0,3,2,2,2,True,True
3991,84,8,0,3,3,3,3,0,True,False
3992,84,9,1,1,1,4,0,3,False,True
3993,84,10,0,1,2,0,2,-1,True,False
3994,84,11,0,0,0,1,0,1,False,True
3995,84,12,0,0,0,1,0,1,False,True
3996,84,13,0,0,0,0,0,0,False,False
3997,84,14,0,1,0,2,0,1,False,True
3998,84,15,2,0,3,0,1,0,True,False
3999,84,16,1,0,0,0,-1,0,False,False
4000,84,17,0,0,0,1,0,1,False,True
4001,84,18,0,0,0,0,0,0,False,False
4002,84,19,1,0,2,0,1,0,True,False
4003,84,20,1,0,0,1,-1,1,False,True
4004,84,21,0,0,0,2,0,2,False,True
4005,84,22,0,0,0,0,0,0,False,False
4006,84,23,0,0,1,1,1,1,True,True
4007,84,24,0,0,1,0,1,0,True,False
4008,84,25,0,0,1,0,1,0,True,False
4009,84,26,0,0,1,0,1,0,True,False
4010,84,27,0,0,1,0,1,0,True,False
4011,84,28,0,0,0,0,0,0,False,False
4012,84,29,0,0,2,1,2,1,True,True
4013,84,30,0,0,0,1,0,1,False,True
4014,84,31,0,0,2,0,2,0,True,False
4015,84,32,0,0,0,0,0,0,False,False
4016,84,33,0,0,3,0,3,0,True,False
4017,84,34,0,0,1,0,1,0,True,False
4018,84,35,0,0,0,0,0,0,False,False
4019,84,36,0,0,1,0,1,0,True,False
4020,84,37,0,0,3,1,3,1,True,True
4021,84,38,0,0,0,0,0,0,False,False
4022,84,39,0,0,3,1,3,1,True,True
4023,84,40,0,0,0,0,0,0,False,False
4024,84,41,0,0,0,0,0,0,False,False
4025,84,42,0,0,2,0,2,0,True,False
4026,84,43,0,0,0,1,0,1,False,True
4027,84,44,0,0,3,1,3,1,True,True
4028,84,45,0,0,1,1,1,1,True,True
4029,84,46,0,0,5,1,5,1,True,True
4030,84,47,0,0,5,0,5,0,True,False
4031,84,48,0,0,2,0,2,0,True,False
4032,85,1,4,3,52,24,48,21,True,True
4033,85,2,4,1,48,36,44,35,True,True
4034,85,3,8,10,56,37,48,27,True,True
4035,85,4,9,4,57,37,48,33,True,True
4036,85,5,6,4,48,38,42,34,True,True
4037,85,6,5,10,45,48,40,38,True,True
4038,85,7,6,3,18,30,12,27,True,True
4039,85,8,3,3,24,41,21,38,True,True
4040,85,9,7,12,21,44,14,32,True,True
4041,85,10,2,9,11,26,9,17,True,True
4042,85,11,4,5,12,19,8,14,True,True
4043,85,12,5,4,10,11,5,7,True,True
4044,85,13,5,1,5,5,0,4,False,True
4045,85,14,1,2,6,10,5,8,True,True
4046,85,15,5,2,9,6,4,4,True,True
4047,85,16,4,0,13,7,9,7,True,True
4048,85,17,1,2,3,2,2,0,True,False
4049,85,18,2,2,6,4,4,2,True,True
4050,85,19,4,1,14,5,10,4,True,True
4051,85,20,1,1,7,5,6,4,True,True
4052,85,21,2,2,10,6,8,4,True,True
4053,85,22,0,1,7,6,7,5,True,True
4054,85,23,1,1,13,6,12,5,True,True
4055,85,24,2,1,5,5,3,4,True,True
4056,85,25,2,1,7,3,5,2,True,True
4057,85,26,0,1,7,6,7,5,True,True
4058,85,27,1,0,10,3,9,3,True,True
4059,85,28,1,0,6,1,5,1,True,True
4060,85,29,2,3,11,7,9,4,True,True
4061,85,30,1,0,9,6,8,6,True,True
4062,85,31,2,0,9,11,7,11,True,True
4063,85,32,0,0,11,8,11,8,True,True
4064,85,33,1,2,19,3,18,1,True,True
4065,85,34,1,0,8,3,7,3,True,True
4066,85,35,2,0,12,4,10,4,True,True
4067,85,36,0,0,7,4,7,4,True,True
4068,85,37,2,2,9,7,7,5,True,True
4069,85,38,3,1,14,9,11,8,True,True
4070,85,39,1,1,13,8,12,7,True,True
4071,85,40,3,2,18,6,15,4,True,True
4072,85,41,7,2,28,9,21,7,True,True
4073,85,42,4,1,26,11,22,10,True,True
4074,85,43,5,4,24,10,19,6,True,True
4075,85,44,7,0,27,10,20,10,True,True
4076,85,45,6,1,34,9,28,8,True,True
4077,85,46,4,1,53,13,49,12,True,True
4078,85,47,4,1,42,17,38,16,True,True
4079,85,48,3,2,55,21,52,19,True,True
4080,86,1,1,0,10,3,9,3,True,True
4081,86,2,0,0,9,3,9,3,True,True
4082,86,3,0,0,11,3,11,3,True,True
4083,86,4,0,0,7,3,7,3,True,True
4084,86,5,0,0,7,2,7,2,True,True
4085,86,6,0,0,6,1,6,1,True,True
4086,86,7,0,1,1,2,1,1,True,True
4087,86,8,0,0,3,0,3,0,True,False
4088,86,9,1,0,5,2,4,2,True,True
4089,86,10,0,1,2,4,2,3,True,True
4090,86,11,0,1,2,1,2,0,True,False
4091,86,12,0,0,6,1,6,1,True,True
4092,86,13,0,0,7,3,7,3,True,True
4093,86,14,0,0,8,4,8,4,True,True
4094,86,15,0,0,10,0,10,0,True,False
4095,86,16,0,0,11,2,11,2,True,True
4096,86,17,0,0,13,2,13,2,True,True
4097,86,18,0,0,8,4,8,4,True,True
4098,86,19,0,0,3,1,3,1,True,True
4099,86,20,0,0,3,1,3,1,True,True
4100,86,21,0,0,3,3,3,3,True,True
4101,86,22,0,0,3,1,3,1,True,True
4102,86,23,0,0,5,2,5,2,True,True
4103,86,24,0,0,3,1,3,1,True,True
4104,86,25,1,0,4,1,3,1,True,True
4105,86,26,0,0,6,5,6,5,True,True
4106,86,27,0,0,6,4,6,4,True,True
4107,86,28,0,0,12,2,12,2,True,True
4108,86,29,0,0,11,9,11,9,True,True
4109,86,30,0,0,9,1,9,1,True,True
4110,86,31,0,0,3,2,3,2,True,True
4111,86,32,0,0,8,5,8,5,True,True
4112,86,33,0,0,7,6,7,6,True,True
4113,86,34,0,0,8,2,8,2,True,True
4114,86,35,0,0,8,6,8,6,True,True
4115,86,36,0,0,4,2,4,2,True,True
4116,86,37,0,0,2,4,2,4,True,True
4117,86,38,0,0,7,4,7,4,True,True
4118,86,39,0,1,6,3,6,2,True,True
4119,86,40,1,0,12,4,11,4,True,True
4120,86,41,0,0,13,1,13,1,True,True
4121,86,42,0,0,15,2,15,2,True,True
4122,86,43,1,0,11,1,10,1,True,True
4123,86,44,1,0,13,4,12,4,True,True
4124,86,45,0,0,13,5,13,5,True,True
4125,86,46,0,0,8,5,8,5,True,True
4126,86,47,0,0,11,7,11,7,True,True
4127,86,48,0,0,11,5,11,5,True,True
4128,87,1,1134,1253,2175,1188,1041,-65,True,False
4129,87,2,802,1149,1726,1414,924,265,True,True
4130,87,3,572,932,1359,1450,787,518,True,True
4131,87,4,390,667,998,1431,608,764,True,True
4132,87,5,352,485,802,1502,450,1017,True,True
4133,87,6,243,381,640,1521,397,1140,True,True
4134,87,7,193,370,525,1456,332,1086,True,True
4135,87,8,163,249,395,1272,232,1023,True,True
4136,87,9,218,270,345,1048,127,778,True,True
4137,87,10,254,232,279,640,25,408,True,True
4138,87,11,347,196,227,367,-120,171,False,True
4139,87,12,492,190,294,222,-198,32,False,True
4140,87,13,708,177,647,140,-61,-37,False,False
4141,87,14,1438,176,1819,130,381,-46,True,False
4142,87,15,1648,254,2379,116,731,-138,True,False
4143,87,16,2148,352,2831,150,683,-202,True,False
4144,87,17,2357,413,2834,170,477,-243,True,False
4145,87,18,2535,475,3089,203,554,-272,True,False
4146,87,19,2160,482,3160,263,1000,-219,True,False
4147,87,20,2133,660,2843,315,710,-345,True,False
4148,87,21,1651,671,2361,404,710,-267,True,False
4149,87,22,1692,825,2064,658,372,-167,True,False
4150,87,23,1650,840,1897,617,247,-223,True,False
4151,87,24,1856,956,1778,622,-78,-334,False,False
4152,87,25,1836,954,1629,678,-207,-276,False,False
4153,87,26,1598,968,1489,708,-109,-260,False,False
4154,87,27,1561,893,1452,767,-109,-126,False,False
4155,87,28,1719,920,1601,673,-118,-247,False,False
4156,87,29,1931,901,1568,700,-363,-201,False,False
4157,87,30,1839,887,1570,780,-269,-107,False,False
4158,87,31,1861,938,1555,839,-306,-99,False,False
4159,87,32,1453,860,1220,852,-233,-8,False,False
4160,87,33,1298,770,1113,767,-185,-3,False,False
4161,87,34,1256,766,880,699,-376,-67,False,False
4162,87,35,1563,808,822,625,-741,-183,False,False
4163,87,36,2010,899,1088,748,-922,-151,False,False
4164,87,37,2249,1037,1303,840,-946,-197,False,False
4165,87,38,2355,1083,1489,873,-866,-210,False,False
4166,87,39,2458,1074,1606,917,-852,-157,False,False
4167,87,40,2609,1022,1758,914,-851,-108,False,False
4168,87,41,2568,995,1704,842,-864,-153,False,False
4169,87,42,2327,963,1790,816,-537,-147,False,False
4170,87,43,2493,989,2081,956,-412,-33,False,False
4171,87,44,2354,875,2357,951,3,76,True,True
4172,87,45,2251,867,2465,1115,214,248,True,True
4173,87,46,2046,914,2603,1100,557,186,True,True
4174,87,47,1844,965,2665,1216,821,251,True,True
4175,87,48,1646,868,2598,1144,952,276,True,True
4176,88,1,628,465,644,446,16,-19,True,False
4177,88,2,490,419,479,436,-11,17,False,True
4178,88,3,334,341,428,517,94,176,True,True
4179,88,4,226,263,259,373,33,110,True,True
4180,88,5,155,213,303,486,148,273,True,True
4181,88,6,141,191,189,347,48,156,True,True
4182,88,7,93,147,214,418,121,271,True,True
4183,88,8,72,130,99,294,27,164,True,True
4184,88,9,82,89,136,323,54,234,True,True
4185,88,10,86,69,91,170,5,101,True,True
4186,88,11,89,68,158,151,69,83,True,True
4187,88,12,120,61,125,66,5,5,True,True
4188,88,13,162,55,162,121,0,66,False,True
4189,88,14,363,116,587,147,224,31,True,True
4190,88,15,375,76,983,201,608,125,True,True
4191,88,16,604,124,1501,135,897,11,True,True
4192,88,17,667,100,1892,227,1225,127,True,True
4193,88,18,795,163,2326,317,1531,154,True,True
4194,88,19,697,162,2378,326,1681,164,True,True
4195,88,20,624,222,2232,482,1608,260,True,True
4196,88,21,606,235,1739,526,1133,291,True,True
4197,88,22,713,308,1449,663,736,355,True,True
4198,88,23,779,347,1285,619,506,272,True,True
4199,88,24,1033,436,1287,637,254,201,True,True
4200,88,25,1111,439,1113,604,2,165,True,True
4201,88,26,1008,506,946,559,-62,53,False,True
4202,88,27,984,535,950,538,-34,3,False,True
4203,88,28,1048,488,1008,519,-40,31,False,True
4204,88,29,1012,487,951,494,-61,7,False,True
4205,88,30,1036,490,979,514,-57,24,False,True
4206,88,31,1047,431,858,417,-189,-14,False,False
4207,88,32,909,504,697,422,-212,-82,False,False
4208,88,33,836,418,591,396,-245,-22,False,False
4209,88,34,806,377,498,382,-308,5,False,True
4210,88,35,1050,441,490,388,-560,-53,False,False
4211,88,36,1140,564,530,479,-610,-85,False,False
4212,88,37,1243,426,717,532,-526,106,False,True
4213,88,38,1235,496,741,501,-494,5,False,True
4214,88,39,1194,438,736,489,-458,51,False,True
4215,88,40,1242,439,774,432,-468,-7,False,False
4216,88,41,1166,352,838,466,-328,114,False,True
4217,88,42,1186,426,824,399,-362,-27,False,False
4218,88,43,1216,335,854,405,-362,70,False,True
4219,88,44,1140,435,812,370,-328,-65,False,False
4220,88,45,1029,352,835,397,-194,45,False,True
4221,88,46,928,379,786,322,-142,-57,False,False
4222,88,47,880,332,812,462,-68,130,False,True
4223,88,48,755,376,791,321,36,-55,True,False
4224,89,1,30,12,431,196,401,184,True,True
4225,89,2,20,19,472,237,452,218,True,True
4226,89,3,44,24,446,304,402,280,True,True
4227,89,4,35,31,375,287,340,256,True,True
4228,89,5,23,33,307,338,284,305,True,True
4229,89,6,21,22,242,330,221,308,True,True
4230,89,7,11,28,220,284,209,256,True,True
4231,89,8,15,28,145,294,130,266,True,True
4232,89,9,10,24,129,278,119,254,True,True
4233,89,10,26,22,142,234,116,212,True,True
4234,89,11,23,13,73,161,50,148,True,True
4235,89,12,17,9,56,83,39,74,True,True
4236,89,13,22,8,54,61,32,53,True,True
4237,89,14,45,11,37,39,-8,28,False,True
4238,89,15,16,4,26,31,10,27,True,True
4239,89,16,30,11,49,38,19,27,True,True
4240,89,17,20,11,39,33,19,22,True,True
4241,89,18,20,10,37,19,17,9,True,True
4242,89,19,14,10,45,37,31,27,True,True
4243,89,20,10,4,31,23,21,19,True,True
4244,89,21,7,6,35,26,28,20,True,True
4245,89,22,3,4,40,30,37,26,True,True
4246,89,23,8,11,29,35,21,24,True,True
4247,89,24,16,12,56,36,40,24,True,True
4248,89,25,12,9,55,21,43,12,True,True
4249,89,26,10,6,49,41,39,35,True,True
4250,89,27,6,10,48,35,42,25,True,True
4251,89,28,16,3,56,45,40,42,True,True
4252,89,29,10,5,59,44,49,39,True,True
4253,89,30,6,12,51,42,45,30,True,True
4254,89,31,6,9,78,43,72,34,True,True
4255,89,32,10,3,52,37,42,34,True,True
4256,89,33,7,14,57,40,50,26,True,True
4257,89,34,6,10,44,43,38,33,True,True
4258,89,35,11,10,64,56,53,46,True,True
4259,89,36,9,11,67,42,58,31,True,True
4260,89,37,11,10,77,58,66,48,True,True
4261,89,38,4,13,86,69,82,56,True,True
4262,89,39,11,8,103,72,92,64,True,True
4263,89,40,15,5,116,63,101,58,True,True
4264,89,41,10,7,123,66,113,59,True,True
4265,89,42,9,5,207,56,198,51,True,True
4266,89,43,16,7,234,70,218,63,True,True
4267,89,44,20,6,305,90,285,84,True,True
4268,89,45,17,12,292,87,275,75,True,True
4269,89,46,23,15,345,135,322,120,True,True
4270,89,47,16,19,374,154,358,135,True,True
4271,89,48,35,16,455,171,420,155,True,True
4272,90,1,3188,3257,3067,2365,-121,-892,False,False
4273,90,2,2553,3189,2450,2350,-103,-839,False,False
4274,90,3,2092,2961,2014,2237,-78,-724,False,False
4275,90,4,1703,2647,1474,2160,-229,-487,False,False
4276,90,5,1491,2384,1227,2098,-264,-286,False,False
4277,90,6,1121,2130,993,1937,-128,-193,False,False
4278,90,7,870,1603,812,1674,-58,71,False,True
4279,90,8,791,1339,665,1548,-126,209,False,True
4280,90,9,786,1337,599,1268,-187,-69,False,False
4281,90,10,800,1130,458,768,-342,-362,False,False
4282,90,11,911,833,361,466,-550,-367,False,False
4283,90,12,1202,591,797,344,-405,-247,False,False
4284,90,13,1762,537,591,303,-1171,-234,False,False
4285,90,14,3285,569,1047,343,-2238,-226,False,False
4286,90,15,4026,615,1364,340,-2662,-275,False,False
4287,90,16,4545,752,1898,525,-2647,-227,False,False
4288,90,17,4705,828,2498,580,-2207,-248,False,False
4289,90,18,5000,1164,3141,764,-1859,-400,False,False
4290,90,19,5414,1292,3432,883,-1982,-409,False,False
4291,90,20,5605,1673,3771,1194,-1834,-479,False,False
4292,90,21,4533,1738,3727,1321,-806,-417,False,False
4293,90,22,4341,2098,3377,1423,-964,-675,False,False
4294,90,23,3986,2111,3321,1521,-665,-590,False,False
4295,90,24,4060,2412,3237,1642,-823,-770,False,False
4296,90,25,4227,2392,3708,1805,-519,-587,False,False
4297,90,26,4320,2562,3601,1908,-719,-654,False,False
4298,90,27,4279,2625,3475,1903,-804,-722,False,False
4299,90,28,4488,2791,3363,1912,-1125,-879,False,False
4300,90,29,4364,2568,3345,1908,-1019,-660,False,False
4301,90,30,4280,2541,3278,1828,-1002,-713,False,False
4302,90,31,4109,2444,3405,1846,-704,-598,False,False
4303,90,32,3754,2302,3093,1712,-661,-590,False,False
4304,90,33,3522,2202,2862,1676,-660,-526,False,False
4305,90,34,3075,1922,2530,1502,-545,-420,False,False
4306,90,35,3616,1933,2666,1519,-950,-414,False,False
4307,90,36,4409,2333,3328,1800,-1081,-533,False,False
4308,90,37,5129,2614,3923,1992,-1206,-622,False,False
4309,90,38,6167,2718,4676,2114,-1491,-604,False,False
4310,90,39,6966,2957,5110,2329,-1856,-628,False,False
4311,90,40,7050,2698,5355,2341,-1695,-357,False,False
4312,90,41,6728,2611,5294,2175,-1434,-436,False,False
4313,90,42,6502,2559,5122,2045,-1380,-514,False,False
4314,90,43,6229,2611,4895,1974,-1334,-637,False,False
4315,90,44,5723,2517,4463,2071,-1260,-446,False,False
4316,90,45,5135,2388,4528,2014,-607,-374,False,False
4317,90,46,4745,2431,4482,2041,-263,-390,False,False
4318,90,47,4641,2546,4148,2068,-493,-478,False,False
4319,90,48,4510,2464,3876,1953,-634,-511,False,False
4320,91,1,2,4,65,24,63,20,True,True
4321,91,2,1,1,62,36,61,35,True,True
4322,91,3,3,5,53,44,50,39,True,True
4323,91,4,3,1,45,28,42,27,True,True
4324,91,5,4,4,45,47,41,43,True,True
4325,91,6,1,4,38,33,37,29,True,True
4326,91,7,1,4,30,53,29,49,True,True
4327,91,8,2,2,24,41,22,39,True,True
4328,91,9,2,0,23,35,21,35,True,True
4329,91,10,1,1,22,36,21,35,True,True
4330,91,11,3,1,8,29,5,28,True,True
4331,91,12,0,4,10,19,10,15,True,True
4332,91,13,2,1,6,8,4,7,True,True
4333,91,14,1,0,13,7,12,7,True,True
4334,91,15,3,1,8,8,5,7,True,True
4335,91,16,3,2,14,6,11,4,True,True
4336,91,17,5,1,14,6,9,5,True,True
4337,91,18,2,2,17,5,15,3,True,True
4338,91,19,3,0,21,10,18,10,True,True
4339,91,20,1,1,11,7,10,6,True,True
4340,91,21,4,1,16,6,12,5,True,True
4341,91,22,3,1,19,5,16,4,True,True
4342,91,23,2,2,11,6,9,4,True,True
4343,91,24,1,3,9,11,8,8,True,True
4344,91,25,1,0,14,4,13,4,True,True
4345,91,26,2,0,24,9,22,9,True,True
4346,91,27,0,0,14,6,14,6,True,True
4347,91,28,4,0,19,10,15,10,True,True
4348,91,29,5,1,22,14,17,13,True,True
4349,91,30,4,2,15,11,11,9,True,True
4350,91,31,4,1,18,17,14,16,True,True
4351,91,32,2,0,25,7,23,7,True,True
4352,91,33,5,3,24,11,19,8,True,True
4353,91,34,0,3,17,13,17,10,True,True
4354,91,35,2,1,17,13,15,12,True,True
4355,91,36,4,1,18,11,14,10,True,True
4356,91,37,1,0,18,9,17,9,True,True
4357,91,38,3,0,19,8,16,8,True,True
4358,91,39,2,0,17,11,15,11,True,True
4359,91,40,4,0,44,16,40,16,True,True
4360,91,41,0,1,28,17,28,16,True,True
4361,91,42,0,1,29,14,29,13,True,True
4362,91,43,0,0,33,15,33,15,True,True
4363,91,44,1,0,25,17,24,17,True,True
4364,91,45,1,2,56,21,55,19,True,True
4365,91,46,1,0,52,16,51,16,True,True
4366,91,47,1,1,48,22,47,21,True,True
4367,91,48,2,0,53,12,51,12,True,True
4368,92,1,9,5,120,54,111,49,True,True
4369,92,2,20,5,119,53,99,48,True,True
4370,92,3,10,10,72,51,62,41,True,True
4371,92,4,11,8,69,58,58,50,True,True
4372,92,5,11,8,66,54,55,46,True,True
4373,92,6,13,15,33,50,20,35,True,True
4374,92,7,14,7,31,40,17,33,True,True
4375,92,8,11,13,24,41,13,28,True,True
4376,92,9,10,9,18,52,8,43,True,True
4377,92,10,15,8,19,55,4,47,True,True
4378,92,11,12,10,13,48,1,38,True,True
4379,92,12,8,16,32,30,24,14,True,True
4380,92,13,10,7,32,25,22,18,True,True
4381,92,14,10,9,32,31,22,22,True,True
4382,92,15,14,4,34,24,20,20,True,True
4383,92,16,10,5,40,23,30,18,True,True
4384,92,17,8,2,37,26,29,24,True,True
4385,92,18,23,4,76,29,53,25,True,True
4386,92,19,12,2,67,41,55,39,True,True
4387,92,20,8,7,46,38,38,31,True,True
4388,92,21,10,5,73,33,63,28,True,True
4389,92,22,14,5,63,39,49,34,True,True
4390,92,23,6,3,57,40,51,37,True,True
4391,92,24,9,4,57,39,48,35,True,True
4392,92,25,7,10,48,51,41,41,True,True
4393,92,26,5,5,58,41,53,36,True,True
4394,92,27,10,11,69,40,59,29,True,True
4395,92,28,5,4,55,40,50,36,True,True
4396,92,29,4,5,57,37,53,32,True,True
4397,92,30,7,7,73,38,66,31,True,True
4398,92,31,9,10,80,46,71,36,True,True
4399,92,32,13,5,53,46,40,41,True,True
4400,92,33,9,10,71,58,62,48,True,True
4401,92,34,11,9,84,44,73,35,True,True
4402,92,35,21,12,79,36,58,24,True,True
4403,92,36,15,13,69,46,54,33,True,True
4404,92,37,9,7,85,52,76,45,True,True
4405,92,38,12,4,86,38,74,34,True,True
4406,92,39,9,7,100,48,91,41,True,True
4407,92,40,9,7,96,55,87,48,True,True
4408,92,41,13,3,103,43,90,40,True,True
4409,92,42,6,5,91,38,85,33,True,True
4410,92,43,9,5,96,31,87,26,True,True
4411,92,44,2,5,111,34,109,29,True,True
4412,92,45,9,1,113,42,104,41,True,True
4413,92,46,10,6,128,42,118,36,True,True
4414,92,47,4,4,120,45,116,41,True,True
4415,92,48,9,10,148,40,139,30,True,True
4416,93,1,16,15,31,13,15,-2,True,False
4417,93,2,20,4,25,7,5,3,True,True
4418,93,3,18,5,28,11,10,6,True,True
4419,93,4,9,3,24,4,15,1,True,True
4420,93,5,8,5,8,10,0,5,False,True
4421,93,6,7,6,13,7,6,1,True,True
4422,93,7,4,5,4,16,0,11,False,True
4423,93,8,3,4,7,11,4,7,True,True
4424,93,9,4,4,2,16,-2,12,False,True
4425,93,10,5,5,9,9,4,4,True,True
4426,93,11,12,5,10,15,-2,10,False,True
4427,93,12,19,4,12,12,-7,8,False,True
4428,93,13,21,4,16,8,-5,4,False,True
4429,93,14,13,11,21,6,8,-5,True,False
4430,93,15,27,6,20,11,-7,5,False,True
4431,93,16,30,8,23,15,-7,7,False,True
4432,93,17,27,12,28,25,1,13,True,True
4433,93,18,32,7,40,27,8,20,True,True
4434,93,19,16,6,35,26,19,20,True,True
4435,93,20,19,6,30,36,11,30,True,True
4436,93,21,21,7,33,35,12,28,True,True
4437,93,22,17,8,21,25,4,17,True,True
4438,93,23,20,5,26,34,6,29,True,True
4439,93,24,24,10,28,39,4,29,True,True
4440,93,25,33,15,35,51,2,36,True,True
4441,93,26,30,13,48,112,18,99,True,True
4442,93,27,21,20,39,98,18,78,True,True
4443,93,28,28,22,32,49,4,27,True,True
4444,93,29,22,13,29,32,7,19,True,True
4445,93,30,24,18,32,16,8,-2,True,False
4446,93,31,27,13,20,25,-7,12,False,True
4447,93,32,29,17,20,18,-9,1,False,True
4448,93,33,25,11,19,17,-6,6,False,True
4449,93,34,36,21,30,23,-6,2,False,True
4450,93,35,19,19,22,23,3,4,True,True
4451,93,36,18,19,36,22,18,3,True,True
4452,93,37,18,14,31,16,13,2,True,True
4453,93,38,26,22,65,19,39,-3,True,False
4454,93,39,19,14,54,11,35,-3,True,False
4455,93,40,20,15,52,16,32,1,True,True
4456,93,41,25,17,35,11,10,-6,True,False
4457,93,42,19,10,27,10,8,0,True,False
4458,93,43,14,8,18,4,4,-4,True,False
4459,93,44,20,13,25,10,5,-3,True,False
4460,93,45,27,11,28,10,1,-1,True,False
4461,93,46,24,12,29,12,5,0,True,False
4462,93,47,21,11,37,6,16,-5,True,False
4463,93,48,18,14,32,11,14,-3,True,False
4464,94,1,1,1,31,11,30,10,True,True
4465,94,2,0,1,18,15,18,14,True,True
4466,94,3,0,0,27,13,27,13,True,True
4467,94,4,0,3,20,8,20,5,True,True
4468,94,5,0,0,17,19,17,19,True,True
4469,94,6,0,0,20,19,20,19,True,True
4470,94,7,0,2,20,18,20,16,True,True
4471,94,8,0,1,5,14,5,13,True,True
4472,94,9,1,1,12,21,11,20,True,True
4473,94,10,2,1,13,17,11,16,True,True
4474,94,11,1,3,9,9,8,6,True,True
4475,94,12,0,0,6,4,6,4,True,True
4476,94,13,0,1,4,4,4,3,True,True
4477,94,14,0,1,3,6,3,5,True,True
4478,94,15,1,0,2,2,1,2,True,True
4479,94,16,3,0,10,5,7,5,True,True
4480,94,17,1,0,2,4,1,4,True,True
4481,94,18,0,0,8,2,8,2,True,True
4482,94,19,0,0,6,3,6,3,True,True
4483,94,20,0,1,2,3,2,2,True,True
4484,94,21,0,1,3,1,3,0,True,False
4485,94,22,0,0,2,1,2,1,True,True
4486,94,23,1,0,5,3,4,3,True,True
4487,94,24,1,0,1,6,0,6,False,True
4488,94,25,1,0,2,4,1,4,True,True
4489,94,26,0,0,3,4,3,4,True,True
4490,94,27,0,0,7,3,7,3,True,True
4491,94,28,1,0,1,4,0,4,False,True
4492,94,29,1,0,7,1,6,1,True,True
4493,94,30,0,0,4,3,4,3,True,True
4494,94,31,1,1,6,2,5,1,True,True
4495,94,32,0,0,5,4,5,4,True,True
4496,94,33,0,0,5,2,5,2,True,True
4497,94,34,0,1,4,2,4,1,True,True
4498,94,35,0,0,1,3,1,3,True,True
4499,94,36,2,0,5,5,3,5,True,True
4500,94,37,0,0,5,5,5,5,True,True
4501,94,38,0,0,9,10,9,10,True,True
4502,94,39,2,0,6,6,4,6,True,True
4503,94,40,2,0,10,2,8,2,True,True
4504,94,41,0,0,13,3,13,3,True,True
4505,94,42,0,0,5,0,5,0,True,False
4506,94,43,1,0,6,7,5,7,True,True
4507,94,44,2,1,16,7,14,6,True,True
4508,94,45,0,0,9,9,9,9,True,True
4509,94,46,1,1,12,9,11,8,True,True
4510,94,47,0,1,14,6,14,5,True,True
4511,94,48,0,1,15,8,15,7,True,True
4512,95,1,85,47,738,283,653,236,True,True
4513,95,2,106,65,655,317,549,252,True,True
4514,95,3,100,96,517,389,417,293,True,True
4515,95,4,87,74,411,359,324,285,True,True
4516,95,5,67,81,286,377,219,296,True,True
4517,95,6,51,106,200,333,149,227,True,True
4518,95,7,35,62,166,323,131,261,True,True
4519,95,8,26,58,124,269,98,211,True,True
4520,95,9,13,45,113,231,100,186,True,True
4521,95,10,20,41,74,201,54,160,True,True
4522,95,11,35,23,64,112,29,89,True,True
4523,95,12,53,28,73,58,20,30,True,True
4524,95,13,82,40,84,75,2,35,True,True
4525,95,14,123,32,88,68,-35,36,False,True
4526,95,15,118,25,85,36,-33,11,False,True
4527,95,16,180,49,128,62,-52,13,False,True
4528,95,17,153,55,137,71,-16,16,False,True
4529,95,18,120,40,113,54,-7,14,False,True
4530,95,19,93,53,106,67,13,14,True,True
4531,95,20,58,34,87,69,29,35,True,True
4532,95,21,61,51,99,84,38,33,True,True
4533,95,22,43,37,102,51,59,14,True,True
4534,95,23,40,36,83,63,43,27,True,True
4535,95,24,28,26,112,67,84,41,True,True
4536,95,25,29,31,90,50,61,19,True,True
4537,95,26,24,39,97,68,73,29,True,True
4538,95,27,35,26,109,74,74,48,True,True
4539,95,28,47,23,154,80,107,57,True,True
4540,95,29,45,22,140,73,95,51,True,True
4541,95,30,64,32,158,66,94,34,True,True
4542,95,31,67,47,166,89,99,42,True,True
4543,95,32,47,33,149,87,102,54,True,True
4544,95,33,31,31,127,93,96,62,True,True
4545,95,34,28,29,129,82,101,53,True,True
4546,95,35,22,16,127,105,105,89,True,True
4547,95,36,32,23,165,85,133,62,True,True
4548,95,37,29,24,187,89,158,65,True,True
4549,95,38,34,18,209,99,175,81,True,True
4550,95,39,23,23,223,103,200,80,True,True
4551,95,40,31,23,297,119,266,96,True,True
4552,95,41,27,24,318,119,291,95,True,True
4553,95,42,44,23,406,122,362,99,True,True
4554,95,43,49,17,512,140,463,123,True,True
4555,95,44,53,22,656,157,603,135,True,True
4556,95,45,55,16,677,166,622,150,True,True
4557,95,46,87,20,894,167,807,147,True,True
4558,95,47,67,24,862,168,795,144,True,True
4559,95,48,96,23,837,241,741,218,True,True
4560,96,1,1,0,16,4,15,4,True,True
4561,96,2,0,1,4,2,4,1,True,True
4562,96,3,1,1,4,7,3,6,True,True
4563,96,4,1,0,6,8,5,8,True,True
4564,96,5,2,0,7,5,5,5,True,True
4565,96,6,0,2,3,8,3,6,True,True
4566,96,7,1,3,1,5,0,2,False,True
4567,96,8,0,1,1,8,1,7,True,True
4568,96,9,0,1,4,7,4,6,True,True
4569,96,10,0,0,1,5,1,5,True,True
4570,96,11,0,0,2,3,2,3,True,True
4571,96,12,0,0,1,2,1,2,True,True
4572,96,13,0,0,2,3,2,3,True,True
4573,96,14,3,2,2,4,-1,2,False,True
4574,96,15,4,0,1,1,-3,1,False,True
4575,96,16,1,0,1,4,0,4,False,True
4576,96,17,1,0,2,4,1,4,True,True
4577,96,18,1,0,3,6,2,6,True,True
4578,96,19,2,0,2,3,0,3,False,True
4579,96,20,2,1,4,3,2,2,True,True
4580,96,21,1,0,3,4,2,4,True,True
4581,96,22,1,2,2,3,1,1,True,True
4582,96,23,0,0,2,0,2,0,True,False
4583,96,24,0,1,2,0,2,-1,True,False
4584,96,25,1,0,3,2,2,2,True,True
4585,96,26,0,0,4,3,4,3,True,True
4586,96,27,0,1,3,0,3,-1,True,False
4587,96,28,0,1,2,2,2,1,True,True
4588,96,29,0,0,2,3,2,3,True,True
4589,96,30,0,0,3,1,3,1,True,True
4590,96,31,2,0,2,2,0,2,False,True
4591,96,32,1,0,0,2,-1,2,False,True
4592,96,33,1,1,3,2,2,1,True,True
4593,96,34,0,0,1,1,1,1,True,True
4594,96,35,0,0,3,1,3,1,True,True
4595,96,36,0,0,1,0,1,0,True,False
4596,96,37,0,1,1,2,1,1,True,True
4597,96,38,0,0,2,2,2,2,True,True
4598,96,39,0,0,6,3,6,3,True,True
4599,96,40,0,2,4,2,4,0,True,False
4600,96,41,0,0,3,1,3,1,True,True
4601,96,42,0,1,3,1,3,0,True,False
4602,96,43,0,0,9,4,9,4,True,True
4603,96,44,1,1,7,3,6,2,True,True
4604,96,45,1,1,5,4,4,3,True,True
4605,96,46,0,1,9,0,9,-1,True,False
4606,96,47,0,2,10,9,10,7,True,True
4607,96,48,2,3,11,6,9,3,True,True
4608,97,1,560,534,914,471,354,-63,True,False
4609,97,2,440,527,866,598,426,71,True,True
4610,97,3,363,510,692,578,329,68,True,True
4611,97,4,250,421,498,582,248,161,True,True
4612,97,5,167,308,383,535,216,227,True,True
4613,97,6,108,243,267,522,159,279,True,True
4614,97,7,78,193,215,409,137,216,True,True
4615,97,8,64,160,171,343,107,183,True,True
4616,97,9,49,129,162,303,113,174,True,True
4617,97,10,58,77,119,231,61,154,True,True
4618,97,11,68,47,75,124,7,77,True,True
4619,97,12,86,48,75,83,-11,35,False,True
4620,97,13,108,39,114,66,6,27,True,True
4621,97,14,154,67,104,60,-50,-7,False,False
4622,97,15,151,46,111,57,-40,11,False,True
4623,97,16,181,68,125,49,-56,-19,False,False
4624,97,17,155,47,140,60,-15,13,False,True
4625,97,18,153,88,124,73,-29,-15,False,False
4626,97,19,159,94,127,59,-32,-35,False,False
4627,97,20,165,107,119,94,-46,-13,False,False
4628,97,21,117,104,111,69,-6,-35,False,False
4629,97,22,100,157,136,107,36,-50,True,False
4630,97,23,110,149,114,118,4,-31,True,False
4631,97,24,113,153,124,119,11,-34,True,False
4632,97,25,103,129,128,132,25,3,True,True
4633,97,26,110,148,112,137,2,-11,True,False
4634,97,27,114,147,129,150,15,3,True,True
4635,97,28,120,160,143,140,23,-20,True,False
4636,97,29,110,142,140,125,30,-17,True,False
4637,97,30,100,143,161,157,61,14,True,True
4638,97,31,130,184,176,159,46,-25,True,False
4639,97,32,107,138,156,160,49,22,True,True
4640,97,33,86,121,149,134,63,13,True,True
4641,97,34,124,154,128,141,4,-13,True,False
4642,97,35,116,135,152,150,36,15,True,True
4643,97,36,199,180,263,179,64,-1,True,False
4644,97,37,213,203,293,213,80,10,True,True
4645,97,38,267,226,398,227,131,1,True,True
4646,97,39,284,233,505,321,221,88,True,True
4647,97,40,310,230,616,275,306,45,True,True
4648,97,41,355,232,705,297,350,65,True,True
4649,97,42,421,225,738,247,317,22,True,True
4650,97,43,489,230,868,285,379,55,True,True
4651,97,44,601,278,990,292,389,14,True,True
4652,97,45,602,312,1045,315,443,3,True,True
4653,97,46,695,366,1059,328,364,-38,True,False
4654,97,47,768,388,1091,344,323,-44,True,False
4655,97,48,836,422,1126,420,290,-2,True,False
4656,98,1,2,0,25,11,23,11,True,True
4657,98,2,0,0,22,7,22,7,True,True
4658,98,3,1,2,14,14,13,12,True,True
4659,98,4,0,0,21,9,21,9,True,True
4660,98,5,0,0,12,11,12,11,True,True
4661,98,6,0,1,10,10,10,9,True,True
4662,98,7,1,1,5,15,4,14,True,True
4663,98,8,0,0,8,12,8,12,True,True
4664,98,9,0,0,2,19,2,19,True,True
4665,98,10,0,2,4,9,4,7,True,True
4666,98,11,0,0,3,6,3,6,True,True
4667,98,12,0,1,10,6,10,5,True,True
4668,98,13,2,1,8,9,6,8,True,True
4669,98,14,2,0,10,8,8,8,True,True
4670,98,15,0,0,7,6,7,6,True,True
4671,98,16,0,0,8,3,8,3,True,True
4672,98,17,1,2,13,9,12,7,True,True
4673,98,18,0,0,21,9,21,9,True,True
4674,98,19,1,0,20,11,19,11,True,True
4675,98,20,0,0,22,9,22,9,True,True
4676,98,21,0,0,10,6,10,6,True,True
4677,98,22,0,1,15,10,15,9,True,True
4678,98,23,0,0,12,6,12,6,True,True
4679,98,24,0,2,9,13,9,11,True,True
4680,98,25,1,0,23,7,22,7,True,True
4681,98,26,1,0,15,13,14,13,True,True
4682,98,27,2,0,24,17,22,17,True,True
4683,98,28,1,0,22,19,21,19,True,True
4684,98,29,0,0,26,11,26,11,True,True
4685,98,30,3,0,30,13,27,13,True,True
4686,98,31,0,1,27,17,27,16,True,True
4687,98,32,1,1,27,14,26,13,True,True
4688,98,33,0,0,27,20,27,20,True,True
4689,98,34,0,0,16,12,16,12,True,True
4690,98,35,1,0,29,23,28,23,True,True
4691,98,36,0,0,25,17,25,17,True,True
4692,98,37,2,0,29,13,27,13,True,True
4693,98,38,1,0,25,17,24,17,True,True
4694,98,39,1,0,25,10,24,10,True,True
4695,98,40,2,0,27,5,25,5,True,True
4696,98,41,0,0,20,13,20,13,True,True
4697,98,42,1,0,28,11,27,11,True,True
4698,98,43,0,0,43,11,43,11,True,True
4699,98,44,4,0,41,15,37,15,True,True
4700,98,45,1,0,62,11,61,11,True,True
4701,98,46,2,0,42,7,40,7,True,True
4702,98,47,3,0,40,5,37,5,True,True
4703,98,48,1,0,38,9,37,9,True,True
4704,99,1,0,0,0,0,0,0,False,False
4705,99,2,0,0,1,0,1,0,True,False
4706,99,3,0,0,0,0,0,0,False,False
4707,99,4,0,0,0,0,0,0,False,False
4708,99,5,0,0,0,0,0,0,False,False
4709,99,6,0,0,0,0,0,0,False,False
4710,99,7,0,0,0,0,0,0,False,False
4711,99,8,0,0,0,0,0,0,False,False
4712,99,9,0,0,0,0,0,0,False,False
4713,99,10,0,0,0,0,0,0,False,False
4714,99,11,0,0,0,0,0,0,False,False
4715,99,12,0,0,0,0,0,0,False,False
4716,99,13,0,0,0,0,0,0,False,False
4717,99,14,0,0,0,0,0,0,False,False
4718,99,15,0,0,0,0,0,0,False,False
4719,99,16,0,0,0,0,0,0,False,False
4720,99,17,1,0,0,0,-1,0,False,False
4721,99,18,0,0,0,0,0,0,False,False
4722,99,19,0,0,0,0,0,0,False,False
4723,99,20,0,1,0,0,0,-1,False,False
4724,99,21,0,0,0,0,0,0,False,False
4725,99,22,0,0,0,0,0,0,False,False
4726,99,23,0,0,0,0,0,0,False,False
4727,99,24,0,0,0,0,0,0,False,False
4728,99,25,0,0,0,0,0,0,False,False
4729,99,26,0,0,0,0,0,0,False,False
4730,99,27,0,0,0,0,0,0,False,False
4731,99,28,0,0,0,0,0,0,False,False
4732,99,29,0,0,0,0,0,0,False,False
4733,99,30,0,0,0,0,0,0,False,False
4734,99,31,0,0,0,0,0,0,False,False
4735,99,32,0,0,0,0,0,0,False,False
4736,99,33,0,0,0,0,0,0,False,False
4737,99,34,0,0,0,0,0,0,False,False
4738,99,35,0,0,0,0,0,0,False,False
4739,99,36,0,0,0,0,0,0,False,False
4740,99,37,0,0,0,0,0,0,False,False
4741,99,38,0,0,0,0,0,0,False,False
4742,99,39,0,0,0,0,0,0,False,False
4743,99,40,0,0,0,0,0,0,False,False
4744,99,41,0,0,0,0,0,0,False,False
4745,99,42,0,0,0,0,0,0,False,False
4746,99,43,0,0,0,0,0,0,False,False
4747,99,44,0,0,1,0,1,0,True,False
4748,99,45,0,0,1,0,1,0,True,False
4749,99,46,0,0,0,0,0,0,False,False
4750,99,47,0,0,1,0,1,0,True,False
4751,99,48,0,0,0,0,0,0,False,False
4752,100,1,2479,1648,1963,1453,-516,-195,False,False
4753,100,2,2165,1643,1550,1615,-615,-28,False,False
4754,100,3,1726,1529,1264,1506,-462,-23,False,False
4755,100,4,1277,1438,757,1223,-520,-215,False,False
4756,100,5,1070,1294,548,1134,-522,-160,False,False
4757,100,6,893,1182,529,986,-364,-196,False,False
4758,100,7,673,1105,395,752,-278,-353,False,False
4759,100,8,575,931,319,648,-256,-283,False,False
4760,100,9,529,887,303,607,-226,-280,False,False
4761,100,10,550,643,394,405,-156,-238,False,False
4762,100,11,799,436,461,252,-338,-184,False,False
4763,100,12,2064,310,874,273,-1190,-37,False,False
4764,100,13,3038,387,1411,359,-1627,-28,False,False
4765,100,14,4278,495,2854,444,-1424,-51,False,False
4766,100,15,4861,471,4293,629,-568,158,False,True
4767,100,16,4739,562,5223,800,484,238,True,True
4768,100,17,4756,554,5753,977,997,423,True,True
4769,100,18,5367,730,6767,1252,1400,522,True,True
4770,100,19,5568,887,7072,1399,1504,512,True,True
4771,100,20,5423,1075,6800,1927,1377,852,True,True
4772,100,21,4922,1219,6225,1862,1303,643,True,True
4773,100,22,5024,1363,5759,2103,735,740,True,True
4774,100,23,4986,1564,5470,2232,484,668,True,True
4775,100,24,4894,1674,5179,2312,285,638,True,True
4776,100,25,4677,1710,5100,2050,423,340,True,True
4777,100,26,4536,1679,4900,1987,364,308,True,True
4778,100,27,4365,1732,4608,2136,243,404,True,True
4779,100,28,4770,1723,4893,2162,123,439,True,True
4780,100,29,4809,1910,5095,2103,286,193,True,True
4781,100,30,4860,1866,5334,1987,474,121,True,True
4782,100,31,4582,1705,5287,1982,705,277,True,True
4783,100,32,4027,1624,5065,1785,1038,161,True,True
4784,100,33,3285,1381,4238,1763,953,382,True,True
4785,100,34,2660,1314,3299,1609,639,295,True,True
4786,100,35,2636,1298,2999,1434,363,136,True,True
4787,100,36,3033,1605,3341,1674,308,69,True,True
4788,100,37,3405,1920,3698,1722,293,-198,True,False
4789,100,38,4213,1987,4116,1709,-97,-278,False,False
4790,100,39,4677,1890,4440,1671,-237,-219,False,False
4791,100,40,4998,1987,4245,1728,-753,-259,False,False
4792,100,41,4677,1794,4159,1449,-518,-345,False,False
4793,100,42,4393,1797,4055,1297,-338,-500,False,False
4794,100,43,4291,1736,4138,1342,-153,-394,False,False
4795,100,44,4281,1846,3942,1230,-339,-616,False,False
4796,100,45,4128,1878,3726,1225,-402,-653,False,False
4797,100,46,3791,1984,3249,1196,-542,-788,False,False
4798,100,47,3532,1831,2907,1164,-625,-667,False,False
4799,100,48,3172,1688,2662,1204,-510,-484,False,False
4800,101,1,1,0,14,8,13,8,True,True
4801,101,2,0,0,11,9,11,9,True,True
4802,101,3,0,0,11,5,11,5,True,True
4803,101,4,0,0,8,4,8,4,True,True
4804,101,5,0,1,7,1,7,0,True,False
4805,101,6,0,0,3,8,3,8,True,True
4806,101,7,1,0,5,2,4,2,True,True
4807,101,8,2,0,2,5,0,5,False,True
4808,101,9,0,1,1,8,1,7,True,True
4809,101,10,0,0,3,1,3,1,True,True
4810,101,11,0,0,2,4,2,4,True,True
4811,101,12,0,0,4,5,4,5,True,True
4812,101,13,1,0,6,1,5,1,True,True
4813,101,14,0,0,2,3,2,3,True,True
4814,101,15,3,0,3,1,0,1,False,True
4815,101,16,0,0,7,2,7,2,True,True
4816,101,17,0,1,7,4,7,3,True,True
4817,101,18,0,0,3,4,3,4,True,True
4818,101,19,1,1,8,2,7,1,True,True
4819,101,20,0,0,9,3,9,3,True,True
4820,101,21,1,0,7,2,6,2,True,True
4821,101,22,1,0,4,3,3,3,True,True
4822,101,23,3,0,5,3,2,3,True,True
4823,101,24,1,1,9,1,8,0,True,False
4824,101,25,4,0,8,3,4,3,True,True
4825,101,26,2,0,7,3,5,3,True,True
4826,101,27,4,0,12,5,8,5,True,True
4827,101,28,3,3,16,1,13,-2,True,False
4828,101,29,1,1,12,3,11,2,True,True
4829,101,30,0,0,15,7,15,7,True,True
4830,101,31,2,1,9,2,7,1,True,True
4831,101,32,1,0,16,3,15,3,True,True
4832,101,33,3,3,13,5,10,2,True,True
4833,101,34,1,1,13,1,12,0,True,False
4834,101,35,0,0,10,1,10,1,True,True
4835,101,36,1,0,14,6,13,6,True,True
4836,101,37,1,1,7,7,6,6,True,True
4837,101,38,0,0,14,5,14,5,True,True
4838,101,39,0,0,15,7,15,7,True,True
4839,101,40,0,0,7,7,7,7,True,True
4840,101,41,0,0,15,6,15,6,True,True
4841,101,42,1,2,15,8,14,6,True,True
4842,101,43,0,2,10,10,10,8,True,True
4843,101,44,1,1,23,0,22,-1,True,False
4844,101,45,0,0,21,5,21,5,True,True
4845,101,46,0,0,17,3,17,3,True,True
4846,101,47,0,0,16,8,16,8,True,True
4847,101,48,1,0,21,10,20,10,True,True
4848,102,1,3,2,49,38,46,36,True,True
4849,102,2,5,2,49,43,44,41,True,True
4850,102,3,4,1,42,35,38,34,True,True
4851,102,4,2,2,49,32,47,30,True,True
4852,102,5,4,1,34,46,30,45,True,True
4853,102,6,1,4,28,47,27,43,True,True
4854,102,7,3,3,18,45,15,42,True,True
4855,102,8,2,3,19,29,17,26,True,True
4856,102,9,1,5,18,41,17,36,True,True
4857,102,10,0,3,29,42,29,39,True,True
4858,102,11,1,3,15,31,14,28,True,True
4859,102,12,2,2,16,19,14,17,True,True
4860,102,13,2,0,6,15,4,15,True,True
4861,102,14,2,3,9,5,7,2,True,True
4862,102,15,1,1,5,6,4,5,True,True
4863,102,16,2,2,5,7,3,5,True,True
4864,102,17,2,1,14,6,12,5,True,True
4865,102,18,3,1,12,8,9,7,True,True
4866,102,19,1,2,16,3,15,1,True,True
4867,102,20,1,2,6,5,5,3,True,True
4868,102,21,2,2,16,9,14,7,True,True
4869,102,22,1,1,19,8,18,7,True,True
4870,102,23,3,0,9,2,6,2,True,True
4871,102,24,1,1,9,7,8,6,True,True
4872,102,25,0,0,7,8,7,8,True,True
4873,102,26,1,0,7,6,6,6,True,True
4874,102,27,0,2,11,8,11,6,True,True
4875,102,28,0,0,19,10,19,10,True,True
4876,102,29,2,0,15,8,13,8,True,True
4877,102,30,1,0,16,11,15,11,True,True
4878,102,31,4,0,17,7,13,7,True,True
4879,102,32,3,1,12,9,9,8,True,True
4880,102,33,2,1,7,6,5,5,True,True
4881,102,34,1,1,15,7,14,6,True,True
4882,102,35,0,2,5,10,5,8,True,True
4883,102,36,1,0,14,7,13,7,True,True
4884,102,37,1,1,19,10,18,9,True,True
4885,102,38,0,0,14,7,14,7,True,True
4886,102,39,2,2,21,11,19,9,True,True
4887,102,40,1,0,27,17,26,17,True,True
4888,102,41,0,0,25,14,25,14,True,True
4889,102,42,1,0,29,15,28,15,True,True
4890,102,43,0,0,32,7,32,7,True,True
4891,102,44,1,0,37,9,36,9,True,True
4892,102,45,1,2,55,14,54,12,True,True
4893,102,46,2,1,51,16,49,15,True,True
4894,102,47,2,2,68,21,66,19,True,True
4895,102,48,5,2,62,25,57,23,True,True
4896,103,1,0,0,0,0,0,0,False,False
4897,103,2,0,0,0,0,0,0,False,False
4898,103,3,0,0,0,0,0,0,False,False
4899,103,4,0,0,0,0,0,0,False,False
4900,103,5,0,0,0,0,0,0,False,False
4901,103,6,0,0,0,0,0,0,False,False
4902,103,7,0,0,0,0,0,0,False,False
4903,103,8,0,0,0,0,0,0,False,False
4904,103,9,0,0,0,0,0,0,False,False
4905,103,10,0,0,0,0,0,0,False,False
4906,103,11,0,0,0,0,0,0,False,False
4907,103,12,0,0,0,0,0,0,False,False
4908,103,13,0,0,0,0,0,0,False,False
4909,103,14,0,0,0,0,0,0,False,False
4910,103,15,0,0,0,0,0,0,False,False
4911,103,16,0,0,0,0,0,0,False,False
4912,103,17,0,0,0,0,0,0,False,False
4913,103,18,0,0,0,0,0,0,False,False
4914,103,19,0,0,0,0,0,0,False,False
4915,103,20,0,0,0,0,0,0,False,False
4916,103,21,0,0,0,0,0,0,False,False
4917,103,22,0,0,0,0,0,0,False,False
4918,103,23,0,0,0,0,0,0,False,False
4919,103,24,0,0,0,0,0,0,False,False
4920,103,25,0,0,0,0,0,0,False,False
4921,103,26,0,0,0,0,0,0,False,False
4922,103,27,0,0,0,0,0,0,False,False
4923,103,28,0,0,0,0,0,0,False,False
4924,103,29,0,0,0,0,0,0,False,False
4925,103,30,0,0,0,0,0,0,False,False
4926,103,31,0,0,0,0,0,0,False,False
4927,103,32,0,0,0,0,0,0,False,False
4928,103,33,0,0,0,0,0,0,False,False
4929,103,34,0,0,0,0,0,0,False,False
4930,103,35,0,0,0,0,0,0,False,False
4931,103,36,0,0,0,0,0,0,False,False
4932,103,37,0,0,0,0,0,0,False,False
4933,103,38,0,0,0,0,0,0,False,False
4934,103,39,0,0,0,0,0,0,False,False
4935,103,40,0,0,0,0,0,0,False,False
4936,103,41,0,0,0,0,0,0,False,False
4937,103,42,0,0,0,0,0,0,False,False
4938,103,43,0,0,0,0,0,0,False,False
4939,103,44,0,0,0,0,0,0,False,False
4940,103,45,0,0,0,0,0,0,False,False
4941,103,46,0,0,1,0,1,0,True,False
4942,103,47,0,0,0,0,0,0,False,False
4943,103,48,0,0,0,0,0,0,False,False
4944,104,1,0,0,0,0,0,0,False,False
4945,104,2,0,0,0,0,0,0,False,False
4946,104,3,0,0,0,0,0,0,False,False
4947,104,4,0,0,0,0,0,0,False,False
4948,104,5,0,0,0,0,0,0,False,False
4949,104,6,0,0,0,0,0,0,False,False
4950,104,7,0,0,0,0,0,0,False,False
4951,104,8,0,0,0,0,0,0,False,False
4952,104,9,0,0,0,0,0,0,False,False
4953,104,10,0,0,0,0,0,0,False,False
4954,104,11,0,0,0,0,0,0,False,False
4955,104,12,0,0,0,0,0,0,False,False
4956,104,13,0,0,0,0,0,0,False,False
4957,104,14,0,0,0,0,0,0,False,False
4958,104,15,0,0,0,0,0,0,False,False
4959,104,16,0,0,0,0,0,0,False,False
4960,104,17,0,0,0,0,0,0,False,False
4961,104,18,1,0,0,0,-1,0,False,False
4962,104,19,0,0,0,0,0,0,False,False
4963,104,20,0,0,0,0,0,0,False,False
4964,104,21,0,0,0,0,0,0,False,False
4965,104,22,0,0,0,0,0,0,False,False
4966,104,23,0,0,0,0,0,0,False,False
4967,104,24,0,0,0,0,0,0,False,False
4968,104,25,0,0,0,0,0,0,False,False
4969,104,26,0,0,0,0,0,0,False,False
4970,104,27,0,0,0,0,0,0,False,False
4971,104,28,0,0,0,0,0,0,False,False
4972,104,29,0,0,0,0,0,0,False,False
4973,104,30,0,0,0,0,0,0,False,False
4974,104,31,0,0,0,0,0,0,False,False
4975,104,32,0,0,0,0,0,0,False,False
4976,104,33,0,0,0,0,0,0,False,False
4977,104,34,0,0,0,0,0,0,False,False
4978,104,35,0,0,0,0,0,0,False,False
4979,104,36,0,0,0,0,0,0,False,False
4980,104,37,0,0,0,0,0,0,False,False
4981,104,38,0,0,0,0,0,0,False,False
4982,104,39,0,0,0,0,0,0,False,False
4983,104,40,0,0,0,0,0,0,False,False
4984,104,41,0,0,0,0,0,0,False,False
4985,104,42,0,0,0,0,0,0,False,False
4986,104,43,0,0,0,0,0,0,False,False
4987,104,44,0,0,0,0,0,0,False,False
4988,104,45,1,0,1,0,0,0,False,False
4989,104,46,0,0,0,0,0,0,False,False
4990,104,47,0,0,0,0,0,0,False,False
4991,104,48,0,0,0,0,0,0,False,False
4992,105,1,0,0,0,1,0,1,False,True
4993,105,2,0,0,0,0,0,0,False,False
4994,105,3,0,1,0,1,0,0,False,False
4995,105,4,0,0,0,0,0,0,False,False
4996,105,5,0,0,0,0,0,0,False,False
4997,105,6,0,0,0,0,0,0,False,False
4998,105,7,0,0,0,0,0,0,False,False
4999,105,8,0,0,0,0,0,0,False,False
5000,105,9,0,0,0,0,0,0,False,False
5001,105,10,0,0,1,0,1,0,True,False
5002,105,11,0,0,0,1,0,1,False,True
5003,105,12,0,0,0,0,0,0,False,False
5004,105,13,0,0,0,0,0,0,False,False
5005,105,14,0,0,0,0,0,0,False,False
5006,105,15,0,0,0,0,0,0,False,False
5007,105,16,1,0,0,0,-1,0,False,False
5008,105,17,1,0,0,0,-1,0,False,False
5009,105,18,0,0,0,0,0,0,False,False
5010,105,19,0,0,0,0,0,0,False,False
5011,105,20,0,0,0,0,0,0,False,False
5012,105,21,0,0,1,0,1,0,True,False
5013,105,22,0,1,0,0,0,-1,False,False
5014,105,23,0,0,0,0,0,0,False,False
5015,105,24,0,0,1,0,1,0,True,False
5016,105,25,0,0,0,0,0,0,False,False
5017,105,26,0,0,0,2,0,2,False,True
5018,105,27,0,1,0,0,0,-1,False,False
5019,105,28,0,0,0,0,0,0,False,False
5020,105,29,0,0,0,1,0,1,False,True
5021,105,30,0,0,0,0,0,0,False,False
5022,105,31,0,0,0,0,0,0,False,False
5023,105,32,0,1,0,0,0,-1,False,False
5024,105,33,2,0,1,0,-1,0,False,False
5025,105,34,0,0,0,0,0,0,False,False
5026,105,35,0,0,0,0,0,0,False,False
5027,105,36,0,0,0,0,0,0,False,False
5028,105,37,0,0,0,0,0,0,False,False
5029,105,38,1,0,0,0,-1,0,False,False
5030,105,39,0,0,0,0,0,0,False,False
5031,105,40,0,0,0,0,0,0,False,False
5032,105,41,0,0,0,0,0,0,False,False
5033,105,42,0,0,0,0,0,0,False,False
5034,105,43,0,3,0,2,0,-1,False,False
5035,105,44,0,1,0,2,0,1,False,True
5036,105,45,0,1,0,1,0,0,False,False
5037,105,46,0,2,0,1,0,-1,False,False
5038,105,47,0,1,0,1,0,0,False,False
5039,105,48,0,2,0,2,0,0,False,False
5040,106,1,107,112,346,247,239,135,True,True
5041,106,2,105,123,304,285,199,162,True,True
5042,106,3,60,157,276,262,216,105,True,True
5043,106,4,48,153,215,254,167,101,True,True
5044,106,5,48,122,188,227,140,105,True,True
5045,106,6,25,112,128,216,103,104,True,True
5046,106,7,25,90,96,160,71,70,True,True
5047,106,8,17,78,79,160,62,82,True,True
5048,106,9,21,54,71,151,50,97,True,True
5049,106,10,19,40,47,114,28,74,True,True
5050,106,11,16,28,42,46,26,18,True,True
5051,106,12,14,14,27,39,13,25,True,True
5052,106,13,46,11,30,28,-16,17,False,True
5053,106,14,36,9,29,17,-7,8,False,True
5054,106,15,36,11,30,13,-6,2,False,True
5055,106,16,44,10,30,28,-14,18,False,True
5056,106,17,49,12,44,34,-5,22,False,True
5057,106,18,43,17,47,29,4,12,True,True
5058,106,19,35,13,51,31,16,18,True,True
5059,106,20,25,22,46,23,21,1,True,True
5060,106,21,22,25,61,46,39,21,True,True
5061,106,22,21,21,46,51,25,30,True,True
5062,106,23,19,21,46,63,27,42,True,True
5063,106,24,19,24,79,48,60,24,True,True
5064,106,25,35,17,73,54,38,37,True,True
5065,106,26,30,20,55,55,25,35,True,True
5066,106,27,22,24,68,43,46,19,True,True
5067,106,28,14,17,53,49,39,32,True,True
5068,106,29,11,20,65,63,54,43,True,True
5069,106,30,18,25,72,67,54,42,True,True
5070,106,31,20,18,66,43,46,25,True,True
5071,106,32,20,26,70,57,50,31,True,True
5072,106,33,25,31,76,49,51,18,True,True
5073,106,34,28,18,64,55,36,37,True,True
5074,106,35,31,27,64,54,33,27,True,True
5075,106,36,40,39,85,97,45,58,True,True
5076,106,37,47,35,101,103,54,68,True,True
5077,106,38,52,36,127,100,75,64,True,True
5078,106,39,40,32,160,93,120,61,True,True
5079,106,40,52,31,219,110,167,79,True,True
5080,106,41,48,40,235,129,187,89,True,True
5081,106,42,55,42,270,106,215,64,True,True
5082,106,43,69,45,290,118,221,73,True,True
5083,106,44,96,34,303,128,207,94,True,True
5084,106,45,98,42,349,120,251,78,True,True
5085,106,46,99,57,368,174,269,117,True,True
5086,106,47,109,65,375,181,266,116,True,True
5087,106,48,120,84,373,209,253,125,True,True
5088,107,1,5035,4896,4425,3519,-610,-1377,False,False
5089,107,2,3835,4464,3429,3516,-406,-948,False,False
5090,107,3,2828,4128,2512,3366,-316,-762,False,False
5091,107,4,2020,3754,1961,3358,-59,-396,False,False
5092,107,5,1625,3372,1561,3342,-64,-30,False,False
5093,107,6,1290,2886,1159,2959,-131,73,False,True
5094,107,7,954,2270,937,2772,-17,502,False,True
5095,107,8,769,1886,758,2204,-11,318,False,True
5096,107,9,750,1573,606,1735,-144,162,False,True
5097,107,10,754,1116,477,952,-277,-164,False,False
5098,107,11,1053,754,488,488,-565,-266,False,False
5099,107,12,1637,623,827,389,-810,-234,False,False
5100,107,13,2532,622,1490,349,-1042,-273,False,False
5101,107,14,4810,742,2965,461,-1845,-281,False,False
5102,107,15,6053,916,3269,495,-2784,-421,False,False
5103,107,16,7095,1219,3771,612,-3324,-607,False,False
5104,107,17,7325,1270,4515,626,-2810,-644,False,False
5105,107,18,6611,1688,4803,830,-1808,-858,False,False
5106,107,19,6575,1812,4374,1024,-2201,-788,False,False
5107,107,20,6393,2496,4340,1346,-2053,-1150,False,False
5108,107,21,5891,2359,4115,1592,-1776,-767,False,False
5109,107,22,5641,2914,4108,1793,-1533,-1121,False,False
5110,107,23,5042,2934,4175,1988,-867,-946,False,False
5111,107,24,5154,3246,4266,2237,-888,-1009,False,False
5112,107,25,5011,3096,4382,2300,-629,-796,False,False
5113,107,26,4859,3146,4279,2396,-580,-750,False,False
5114,107,27,4719,2957,4060,2362,-659,-595,False,False
5115,107,28,5183,3108,4043,2297,-1140,-811,False,False
5116,107,29,5475,2969,4413,2271,-1062,-698,False,False
5117,107,30,5599,2855,4329,2267,-1270,-588,False,False
5118,107,31,5167,2707,4137,2232,-1030,-475,False,False
5119,107,32,4772,2603,4131,2197,-641,-406,False,False
5120,107,33,4189,2348,3568,2192,-621,-156,False,False
5121,107,34,3877,2123,3356,2038,-521,-85,False,False
5122,107,35,5289,2483,3680,2059,-1609,-424,False,False
5123,107,36,6566,2940,4863,2571,-1703,-369,False,False
5124,107,37,7904,2962,6312,2998,-1592,36,False,True
5125,107,38,8897,3066,7262,3396,-1635,330,False,True
5126,107,39,8911,3248,7884,3526,-1027,278,False,True
5127,107,40,8835,3311,8346,3546,-489,235,False,True
5128,107,41,8181,3136,8546,3329,365,193,True,True
5129,107,42,8318,3100,8247,3258,-71,158,False,True
5130,107,43,8407,3140,8200,3102,-207,-38,False,False
5131,107,44,8635,3181,7907,3345,-728,164,False,True
5132,107,45,9030,3284,7969,3243,-1061,-41,False,False
5133,107,46,8425,3587,7483,3295,-942,-292,False,False
5134,107,47,8288,3669,7013,3123,-1275,-546,False,False
5135,107,48,7490,3284,6419,2938,-1071,-346,False,False
5136,108,1,4,0,14,10,10,10,True,True
5137,108,2,3,0,23,7,20,7,True,True
5138,108,3,1,0,14,18,13,18,True,True
5139,108,4,1,1,9,8,8,7,True,True
5140,108,5,4,0,10,19,6,19,True,True
5141,108,6,2,4,9,14,7,10,True,True
5142,108,7,1,0,6,17,5,17,True,True
5143,108,8,1,0,4,11,3,11,True,True
5144,108,9,1,1,9,15,8,14,True,True
5145,108,10,1,1,5,11,4,10,True,True
5146,108,11,0,0,3,9,3,9,True,True
5147,108,12,2,0,3,5,1,5,True,True
5148,108,13,0,0,4,6,4,6,True,True
5149,108,14,2,1,4,2,2,1,True,True
5150,108,15,0,0,1,1,1,1,True,True
5151,108,16,1,0,3,2,2,2,True,True
5152,108,17,0,0,3,3,3,3,True,True
5153,108,18,0,0,2,1,2,1,True,True
5154,108,19,0,0,3,2,3,2,True,True
5155,108,20,0,0,2,2,2,2,True,True
5156,108,21,0,0,2,1,2,1,True,True
5157,108,22,0,0,6,3,6,3,True,True
5158,108,23,1,1,4,4,3,3,True,True
5159,108,24,0,0,1,2,1,2,True,True
5160,108,25,0,0,2,2,2,2,True,True
5161,108,26,1,1,8,0,7,-1,True,False
5162,108,27,1,0,5,2,4,2,True,True
5163,108,28,1,0,3,2,2,2,True,True
5164,108,29,0,0,6,5,6,5,True,True
5165,108,30,0,0,6,6,6,6,True,True
5166,108,31,1,0,9,3,8,3,True,True
5167,108,32,0,0,2,4,2,4,True,True
5168,108,33,0,0,1,2,1,2,True,True
5169,108,34,1,0,6,2,5,2,True,True
5170,108,35,1,0,4,4,3,4,True,True
5171,108,36,0,0,3,4,3,4,True,True
5172,108,37,2,0,8,9,6,9,True,True
5173,108,38,0,0,10,2,10,2,True,True
5174,108,39,0,2,11,1,11,-1,True,False
5175,108,40,0,0,12,9,12,9,True,True
5176,108,41,0,1,11,6,11,5,True,True
5177,108,42,2,0,15,2,13,2,True,True
5178,108,43,2,1,16,6,14,5,True,True
5179,108,44,2,0,14,5,12,5,True,True
5180,108,45,2,0,17,4,15,4,True,True
5181,108,46,2,0,16,4,14,4,True,True
5182,108,47,0,0,13,9,13,9,True,True
5183,108,48,3,1,28,3,25,2,True,True
5184,109,1,0,1,2,0,2,-1,True,False
5185,109,2,0,1,2,2,2,1,True,True
5186,109,3,0,0,1,1,1,1,True,True
5187,109,4,0,0,4,3,4,3,True,True
5188,109,5,0,0,1,5,1,5,True,True
5189,109,6,0,0,2,4,2,4,True,True
5190,109,7,0,0,2,3,2,3,True,True
5191,109,8,0,0,2,2,2,2,True,True
5192,109,9,0,0,1,2,1,2,True,True
5193,109,10,0,0,1,3,1,3,True,True
5194,109,11,0,0,0,2,0,2,False,True
5195,109,12,0,0,0,0,0,0,False,False
5196,109,13,0,0,0,0,0,0,False,False
5197,109,14,0,0,3,1,3,1,True,True
5198,109,15,0,0,0,0,0,0,False,False
5199,109,16,0,0,0,0,0,0,False,False
5200,109,17,0,0,1,0,1,0,True,False
5201,109,18,0,0,1,0,1,0,True,False
5202,109,19,0,0,1,0,1,0,True,False
5203,109,20,0,0,0,1,0,1,False,True
5204,109,21,0,0,0,2,0,2,False,True
5205,109,22,0,0,0,0,0,0,False,False
5206,109,23,2,0,3,0,1,0,True,False
5207,109,24,0,0,2,1,2,1,True,True
5208,109,25,0,0,1,0,1,0,True,False
5209,109,26,0,0,0,0,0,0,False,False
5210,109,27,0,0,1,0,1,0,True,False
5211,109,28,0,0,0,2,0,2,False,True
5212,109,29,1,0,0,0,-1,0,False,False
5213,109,30,1,0,1,1,0,1,False,True
5214,109,31,2,0,2,0,0,0,False,False
5215,109,32,0,0,0,0,0,0,False,False
5216,109,33,0,0,1,0,1,0,True,False
5217,109,34,0,0,1,1,1,1,True,True
5218,109,35,0,0,0,0,0,0,False,False
5219,109,36,0,0,0,0,0,0,False,False
5220,109,37,0,0,0,0,0,0,False,False
5221,109,38,0,0,2,2,2,2,True,True
5222,109,39,0,0,2,2,2,2,True,True
5223,109,40,0,0,0,0,0,0,False,False
5224,109,41,0,0,1,0,1,0,True,False
5225,109,42,0,0,5,1,5,1,True,True
5226,109,43,0,0,1,1,1,1,True,True
5227,109,44,0,0,6,1,6,1,True,True
5228,109,45,0,0,3,1,3,1,True,True
5229,109,46,0,0,6,0,6,0,True,False
5230,109,47,0,0,3,0,3,0,True,False
5231,109,48,0,0,5,0,5,0,True,False
5232,110,1,0,0,0,0,0,0,False,False
5233,110,2,0,0,0,0,0,0,False,False
5234,110,3,0,0,0,0,0,0,False,False
5235,110,4,0,0,0,0,0,0,False,False
5236,110,5,0,1,0,0,0,-1,False,False
5237,110,6,0,0,0,0,0,0,False,False
5238,110,7,0,1,0,1,0,0,False,False
5239,110,8,0,0,0,1,0,1,False,True
5240,110,9,0,0,0,0,0,0,False,False
5241,110,10,0,0,0,0,0,0,False,False
5242,110,11,0,0,0,0,0,0,False,False
5243,110,12,0,0,0,0,0,0,False,False
5244,110,13,0,0,0,0,0,0,False,False
5245,110,14,0,2,0,1,0,-1,False,False
5246,110,15,0,0,0,0,0,0,False,False
5247,110,16,0,0,0,1,0,1,False,True
5248,110,17,0,0,0,0,0,0,False,False
5249,110,18,0,0,0,0,0,0,False,False
5250,110,19,0,0,0,0,0,0,False,False
5251,110,20,0,0,0,0,0,0,False,False
5252,110,21,0,0,0,0,0,0,False,False
5253,110,22,0,0,0,0,0,0,False,False
5254,110,23,0,0,1,0,1,0,True,False
5255,110,24,0,0,0,0,0,0,False,False
5256,110,25,0,0,0,0,0,0,False,False
5257,110,26,0,0,0,0,0,0,False,False
5258,110,27,0,1,0,2,0,1,False,True
5259,110,28,0,2,0,1,0,-1,False,False
5260,110,29,0,1,0,1,0,0,False,False
5261,110,30,0,0,0,0,0,0,False,False
5262,110,31,0,1,0,0,0,-1,False,False
5263,110,32,0,0,0,0,0,0,False,False
5264,110,33,0,0,0,0,0,0,False,False
5265,110,34,0,0,0,0,0,0,False,False
5266,110,35,0,0,0,0,0,0,False,False
5267,110,36,0,0,0,0,0,0,False,False
5268,110,37,0,0,0,0,0,0,False,False
5269,110,38,0,0,0,0,0,0,False,False
5270,110,39,0,0,0,0,0,0,False,False
5271,110,40,0,0,0,0,0,0,False,False
5272,110,41,0,0,0,0,0,0,False,False
5273,110,42,0,0,0,0,0,0,False,False
5274,110,43,0,0,0,1,0,1,False,True
5275,110,44,0,0,0,0,0,0,False,False
5276,110,45,0,0,0,0,0,0,False,False
5277,110,46,0,0,0,0,0,0,False,False
5278,110,47,0,0,0,0,0,0,False,False
5279,110,48,0,0,0,0,0,0,False,False
5280,111,1,0,0,8,6,8,6,True,True
5281,111,2,1,0,7,6,6,6,True,True
5282,111,3,0,0,5,4,5,4,True,True
5283,111,4,1,0,3,5,2,5,True,True
5284,111,5,0,2,2,6,2,4,True,True
5285,111,6,0,3,5,10,5,7,True,True
5286,111,7,1,0,6,7,5,7,True,True
5287,111,8,0,0,2,4,2,4,True,True
5288,111,9,1,0,0,3,-1,3,False,True
5289,111,10,0,0,1,5,1,5,True,True
5290,111,11,0,0,2,0,2,0,True,False
5291,111,12,0,0,2,2,2,2,True,True
5292,111,13,1,0,0,0,-1,0,False,False
5293,111,14,0,0,2,1,2,1,True,True
5294,111,15,0,0,2,1,2,1,True,True
5295,111,16,1,1,0,0,-1,-1,False,False
5296,111,17,1,0,1,2,0,2,False,True
5297,111,18,1,0,3,0,2,0,True,False
5298,111,19,3,0,3,0,0,0,False,False
5299,111,20,1,0,2,0,1,0,True,False
5300,111,21,0,0,1,2,1,2,True,True
5301,111,22,0,0,2,0,2,0,True,False
5302,111,23,0,1,0,0,0,-1,False,False
5303,111,24,1,1,1,0,0,-1,False,False
5304,111,25,0,2,3,0,3,-2,True,False
5305,111,26,0,0,0,3,0,3,False,True
5306,111,27,0,1,2,1,2,0,True,False
5307,111,28,0,0,1,2,1,2,True,True
5308,111,29,0,0,1,0,1,0,True,False
5309,111,30,0,0,1,1,1,1,True,True
5310,111,31,1,1,1,2,0,1,False,True
5311,111,32,0,0,2,2,2,2,True,True
5312,111,33,0,1,1,0,1,-1,True,False
5313,111,34,0,0,2,1,2,1,True,True
5314,111,35,0,0,1,2,1,2,True,True
5315,111,36,0,0,0,0,0,0,False,False
5316,111,37,1,0,5,3,4,3,True,True
5317,111,38,0,0,1,0,1,0,True,False
5318,111,39,1,0,5,1,4,1,True,True
5319,111,40,0,0,2,3,2,3,True,True
5320,111,41,1,0,8,7,7,7,True,True
5321,111,42,0,0,7,0,7,0,True,False
5322,111,43,1,0,6,0,5,0,True,False
5323,111,44,0,2,2,1,2,-1,True,False
5324,111,45,0,0,13,3,13,3,True,True
5325,111,46,1,3,11,4,10,1,True,True
5326,111,47,0,0,8,2,8,2,True,True
5327,111,48,0,1,10,6,10,5,True,True
5328,112,1,728,706,1884,980,1156,274,True,True
5329,112,2,565,723,1808,1118,1243,395,True,True
5330,112,3,485,789,1427,1247,942,458,True,True
5331,112,4,371,798,1118,1231,747,433,True,True
5332,112,5,292,785,907,1194,615,409,True,True
5333,112,6,239,680,661,1104,422,424,True,True
5334,112,7,203,591,580,962,377,371,True,True
5335,112,8,153,463,442,812,289,349,True,True
5336,112,9,98,343,431,789,333,446,True,True
5337,112,10,48,147,292,536,244,389,True,True
5338,112,11,36,83,176,318,140,235,True,True
5339,112,12,54,67,136,218,82,151,True,True
5340,112,13,39,47,130,140,91,93,True,True
5341,112,14,50,31,152,96,102,65,True,True
5342,112,15,53,41,134,79,81,38,True,True
5343,112,16,33,24,123,88,90,64,True,True
5344,112,17,42,43,147,97,105,54,True,True
5345,112,18,44,40,164,93,120,53,True,True
5346,112,19,45,45,161,108,116,63,True,True
5347,112,20,45,48,176,119,131,71,True,True
5348,112,21,43,34,189,116,146,82,True,True
5349,112,22,69,33,184,117,115,84,True,True
5350,112,23,35,59,209,142,174,83,True,True
5351,112,24,51,51,183,138,132,87,True,True
5352,112,25,39,57,189,183,150,126,True,True
5353,112,26,41,71,235,188,194,117,True,True
5354,112,27,47,58,240,176,193,118,True,True
5355,112,28,44,60,229,189,185,129,True,True
5356,112,29,24,62,235,185,211,123,True,True
5357,112,30,50,64,271,212,221,148,True,True
5358,112,31,52,62,217,223,165,161,True,True
5359,112,32,53,72,258,205,205,133,True,True
5360,112,33,55,81,271,212,216,131,True,True
5361,112,34,66,92,240,216,174,124,True,True
5362,112,35,118,102,274,235,156,133,True,True
5363,112,36,155,140,397,289,242,149,True,True
5364,112,37,163,122,506,314,343,192,True,True
5365,112,38,160,134,640,325,480,191,True,True
5366,112,39,241,166,823,409,582,243,True,True
5367,112,40,249,184,999,417,750,233,True,True
5368,112,41,291,181,1208,411,917,230,True,True
5369,112,42,396,184,1424,443,1028,259,True,True
5370,112,43,434,219,1543,509,1109,290,True,True
5371,112,44,473,250,1713,547,1240,297,True,True
5372,112,45,518,275,1770,603,1252,328,True,True
5373,112,46,637,342,2006,623,1369,281,True,True
5374,112,47,723,372,2007,740,1284,368,True,True
5375,112,48,744,445,2016,776,1272,331,True,True
5376,113,1,3023,2516,2267,2191,-756,-325,False,False
5377,113,2,2426,2632,1899,2245,-527,-387,False,False
5378,113,3,1878,2714,1435,2097,-443,-617,False,False
5379,113,4,1303,2693,1028,1851,-275,-842,False,False
5380,113,5,1015,2310,915,1713,-100,-597,False,False
5381,113,6,852,2091,657,1464,-195,-627,False,False
5382,113,7,674,1707,553,1300,-121,-407,False,False
5383,113,8,475,1221,382,966,-93,-255,False,False
5384,113,9,490,909,367,801,-123,-108,False,False
5385,113,10,496,666,262,481,-234,-185,False,False
5386,113,11,464,416,249,242,-215,-174,False,False
5387,113,12,872,306,407,199,-465,-107,False,False
5388,113,13,1286,253,513,163,-773,-90,False,False
5389,113,14,2643,310,900,213,-1743,-97,False,False
5390,113,15,3318,434,1179,245,-2139,-189,False,False
5391,113,16,4152,562,1872,369,-2280,-193,False,False
5392,113,17,4677,669,2347,442,-2330,-227,False,False
5393,113,18,5010,867,2993,655,-2017,-212,False,False
5394,113,19,5499,1034,3546,749,-1953,-285,False,False
5395,113,20,5152,1296,3715,948,-1437,-348,False,False
5396,113,21,4284,1414,3560,1081,-724,-333,False,False
5397,113,22,4060,1662,3561,1383,-499,-279,False,False
5398,113,23,3895,1653,3384,1437,-511,-216,False,False
5399,113,24,3823,1745,3461,1378,-362,-367,False,False
5400,113,25,3807,1869,3748,1537,-59,-332,False,False
5401,113,26,3671,1949,3541,1565,-130,-384,False,False
5402,113,27,3769,1828,3357,1635,-412,-193,False,False
5403,113,28,3794,1926,3566,1646,-228,-280,False,False
5404,113,29,3747,2009,3531,1571,-216,-438,False,False
5405,113,30,3634,1943,3369,1478,-265,-465,False,False
5406,113,31,3575,1876,3353,1659,-222,-217,False,False
5407,113,32,3351,1858,3156,1592,-195,-266,False,False
5408,113,33,3005,1659,2967,1564,-38,-95,False,False
5409,113,34,2918,1413,2726,1391,-192,-22,False,False
5410,113,35,3700,1733,2861,1393,-839,-340,False,False
5411,113,36,4044,1978,3448,1719,-596,-259,False,False
5412,113,37,4774,2126,4269,1835,-505,-291,False,False
5413,113,38,5412,2340,4886,2054,-526,-286,False,False
5414,113,39,6006,2220,5643,2265,-363,45,False,True
5415,113,40,6176,2240,6020,2269,-156,29,False,True
5416,113,41,5931,2235,5910,2189,-21,-46,False,False
5417,113,42,5934,2226,5770,2132,-164,-94,False,False
5418,113,43,5675,2262,5316,2167,-359,-95,False,False
5419,113,44,5309,2317,4664,1904,-645,-413,False,False
5420,113,45,4962,2364,4325,1754,-637,-610,False,False
5421,113,46,4605,2390,4062,1788,-543,-602,False,False
5422,113,47,4380,2278,3719,1698,-661,-580,False,False
5423,113,48,4194,1966,3536,1705,-658,-261,False,False
5424,114,1,4683,3613,2583,2880,-2100,-733,False,False
5425,114,2,4083,3735,2188,2888,-1895,-847,False,False
5426,114,3,3373,3788,1630,2546,-1743,-1242,False,False
5427,114,4,2591,3892,1228,2296,-1363,-1596,False,False
5428,114,5,2250,3978,1022,2034,-1228,-1944,False,False
5429,114,6,1788,4004,753,1785,-1035,-2219,False,False
5430,114,7,1437,3511,600,1564,-837,-1947,False,False
5431,114,8,1135,3010,449,1144,-686,-1866,False,False
5432,114,9,1024,2199,362,915,-662,-1284,False,False
5433,114,10,757,1264,240,447,-517,-817,False,False
5434,114,11,576,803,168,261,-408,-542,False,False
5435,114,12,645,362,335,228,-310,-134,False,False
5436,114,13,874,272,294,137,-580,-135,False,False
5437,114,14,1387,263,568,131,-819,-132,False,False
5438,114,15,1441,281,696,158,-745,-123,False,False
5439,114,16,1906,341,1158,230,-748,-111,False,False
5440,114,17,2015,392,1540,346,-475,-46,False,False
5441,114,18,2455,521,1893,516,-562,-5,False,False
5442,114,19,2585,583,2352,612,-233,29,False,True
5443,114,20,2325,770,2454,743,129,-27,True,False
5444,114,21,1990,781,2457,930,467,149,True,True
5445,114,22,1914,948,2222,1172,308,224,True,True
5446,114,23,1896,1044,2096,1264,200,220,True,True
5447,114,24,2096,1237,2194,1454,98,217,True,True
5448,114,25,2293,1231,2480,1672,187,441,True,True
5449,114,26,2247,1468,2477,1703,230,235,True,True
5450,114,27,2246,1414,2433,1580,187,166,True,True
5451,114,28,2313,1437,2163,1469,-150,32,False,True
5452,114,29,2442,1508,2123,1417,-319,-91,False,False
5453,114,30,2445,1537,2133,1400,-312,-137,False,False
5454,114,31,2318,1563,2104,1302,-214,-261,False,False
5455,114,32,2191,1444,2156,1280,-35,-164,False,False
5456,114,33,2092,1332,1901,1262,-191,-70,False,False
5457,114,34,2192,1305,1946,1180,-246,-125,False,False
5458,114,35,2943,1586,2027,1195,-916,-391,False,False
5459,114,36,3034,1627,2915,1473,-119,-154,False,False
5460,114,37,3412,1689,3645,1679,233,-10,True,False
5461,114,38,3837,1906,4321,1838,484,-68,True,False
5462,114,39,4058,1848,4904,2145,846,297,True,True
5463,114,40,4444,1877,5570,2256,1126,379,True,True
5464,114,41,4586,1788,5787,2516,1201,728,True,True
5465,114,42,4986,1908,5455,2303,469,395,True,True
5466,114,43,5500,2141,5065,2299,-435,158,False,True
5467,114,44,5681,2391,4839,2182,-842,-209,False,False
5468,114,45,5515,2344,4320,2098,-1195,-246,False,False
5469,114,46,5569,2577,4063,2073,-1506,-504,False,False
5470,114,47,5700,2686,3977,1989,-1723,-697,False,False
5471,114,48,5814,2667,3681,2036,-2133,-631,False,False
5472,115,1,0,0,6,4,6,4,True,True
5473,115,2,1,0,1,5,0,5,False,True
5474,115,3,0,0,4,2,4,2,True,True
5475,115,4,0,0,0,5,0,5,False,True
5476,115,5,1,0,2,3,1,3,True,True
5477,115,6,1,0,3,4,2,4,True,True
5478,115,7,0,0,1,1,1,1,True,True
5479,115,8,0,0,0,2,0,2,False,True
5480,115,9,0,0,0,3,0,3,False,True
5481,115,10,0,0,1,2,1,2,True,True
5482,115,11,0,0,0,1,0,1,False,True
5483,115,12,0,0,0,1,0,1,False,True
5484,115,13,0,0,2,0,2,0,True,False
5485,115,14,0,0,2,0,2,0,True,False
5486,115,15,0,0,0,0,0,0,False,False
5487,115,16,0,0,0,0,0,0,False,False
5488,115,17,0,0,1,0,1,0,True,False
5489,115,18,0,0,0,0,0,0,False,False
5490,115,19,0,0,1,4,1,4,True,True
5491,115,20,0,0,1,0,1,0,True,False
5492,115,21,0,0,2,0,2,0,True,False
5493,115,22,0,0,4,0,4,0,True,False
5494,115,23,0,0,1,0,1,0,True,False
5495,115,24,0,0,1,1,1,1,True,True
5496,115,25,0,1,0,1,0,0,False,False
5497,115,26,0,0,1,0,1,0,True,False
5498,115,27,0,0,1,0,1,0,True,False
5499,115,28,0,0,3,0,3,0,True,False
5500,115,29,0,0,0,1,0,1,False,True
5501,115,30,0,0,4,0,4,0,True,False
5502,115,31,0,0,2,2,2,2,True,True
5503,115,32,0,0,1,0,1,0,True,False
5504,115,33,0,0,1,0,1,0,True,False
5505,115,34,0,0,3,0,3,0,True,False
5506,115,35,0,1,1,1,1,0,True,False
5507,115,36,0,0,0,0,0,0,False,False
5508,115,37,0,0,0,3,0,3,False,True
5509,115,38,0,0,1,0,1,0,True,False
5510,115,39,0,0,2,0,2,0,True,False
5511,115,40,0,0,2,1,2,1,True,True
5512,115,41,0,0,1,1,1,1,True,True
5513,115,42,0,0,6,0,6,0,True,False
5514,115,43,0,0,1,0,1,0,True,False
5515,115,44,0,0,3,1,3,1,True,True
5516,115,45,0,1,2,0,2,-1,True,False
5517,115,46,0,0,5,0,5,0,True,False
5518,115,47,0,0,6,2,6,2,True,True
5519,115,48,0,0,4,2,4,2,True,True
5520,116,1,164,174,998,528,834,354,True,True
5521,116,2,182,158,923,629,741,471,True,True
5522,116,3,151,180,805,669,654,489,True,True
5523,116,4,122,143,677,724,555,581,True,True
5524,116,5,111,137,576,658,465,521,True,True
5525,116,6,92,106,530,692,438,586,True,True
5526,116,7,65,95,475,588,410,493,True,True
5527,116,8,75,120,364,577,289,457,True,True
5528,116,9,75,110,332,562,257,452,True,True
5529,116,10,75,94,279,484,204,390,True,True
5530,116,11,82,94,199,311,117,217,True,True
5531,116,12,122,93,126,205,4,112,True,True
5532,116,13,143,74,113,133,-30,59,False,True
5533,116,14,206,103,111,94,-95,-9,False,False
5534,116,15,278,76,117,83,-161,7,False,True
5535,116,16,419,81,148,85,-271,4,False,True
5536,116,17,436,89,155,76,-281,-13,False,False
5537,116,18,492,127,146,96,-346,-31,False,False
5538,116,19,368,125,149,109,-219,-16,False,False
5539,116,20,236,158,140,142,-96,-16,False,False
5540,116,21,200,144,170,134,-30,-10,False,False
5541,116,22,178,149,182,129,4,-20,True,False
5542,116,23,131,120,196,128,65,8,True,True
5543,116,24,130,150,195,143,65,-7,True,False
5544,116,25,128,121,200,150,72,29,True,True
5545,116,26,138,120,214,162,76,42,True,True
5546,116,27,121,95,214,149,93,54,True,True
5547,116,28,120,125,210,163,90,38,True,True
5548,116,29,120,122,233,169,113,47,True,True
5549,116,30,126,115,247,193,121,78,True,True
5550,116,31,124,118,265,192,141,74,True,True
5551,116,32,128,97,261,189,133,92,True,True
5552,116,33,99,95,256,166,157,71,True,True
5553,116,34,89,87,248,212,159,125,True,True
5554,116,35,131,84,253,166,122,82,True,True
5555,116,36,155,98,370,188,215,90,True,True
5556,116,37,163,106,462,221,299,115,True,True
5557,116,38,173,111,490,211,317,100,True,True
5558,116,39,157,84,542,227,385,143,True,True
5559,116,40,173,93,605,203,432,110,True,True
5560,116,41,170,100,536,242,366,142,True,True
5561,116,42,157,91,601,276,444,185,True,True
5562,116,43,185,104,722,295,537,191,True,True
5563,116,44,220,103,824,304,604,201,True,True
5564,116,45,199,134,858,413,659,279,True,True
5565,116,46,248,142,901,399,653,257,True,True
5566,116,47,262,158,915,426,653,268,True,True
5567,116,48,259,158,936,487,677,329,True,True
5568,117,1,0,1,6,4,6,3,True,True
5569,117,2,0,0,4,3,4,3,True,True
5570,117,3,1,1,4,5,3,4,True,True
5571,117,4,0,0,8,4,8,4,True,True
5572,117,5,0,0,8,1,8,1,True,True
5573,117,6,0,0,1,3,1,3,True,True
5574,117,7,0,0,1,4,1,4,True,True
5575,117,8,0,0,1,1,1,1,True,True
5576,117,9,0,0,1,2,1,2,True,True
5577,117,10,0,0,0,3,0,3,False,True
5578,117,11,0,0,1,3,1,3,True,True
5579,117,12,0,0,0,4,0,4,False,True
5580,117,13,0,0,3,0,3,0,True,False
5581,117,14,0,0,2,3,2,3,True,True
5582,117,15,0,0,2,0,2,0,True,False
5583,117,16,0,0,1,1,1,1,True,True
5584,117,17,0,0,1,2,1,2,True,True
5585,117,18,0,0,0,0,0,0,False,False
5586,117,19,0,0,0,4,0,4,False,True
5587,117,20,0,1,0,7,0,6,False,True
5588,117,21,0,0,0,0,0,0,False,False
5589,117,22,0,0,0,0,0,0,False,False
5590,117,23,0,0,2,3,2,3,True,True
5591,117,24,0,0,0,0,0,0,False,False
5592,117,25,0,0,2,0,2,0,True,False
5593,117,26,0,0,5,1,5,1,True,True
5594,117,27,0,0,1,2,1,2,True,True
5595,117,28,0,0,4,4,4,4,True,True
5596,117,29,1,0,4,3,3,3,True,True
5597,117,30,0,0,0,4,0,4,False,True
5598,117,31,0,0,2,0,2,0,True,False
5599,117,32,0,0,3,0,3,0,True,False
5600,117,33,0,0,4,2,4,2,True,True
5601,117,34,0,1,4,3,4,2,True,True
5602,117,35,0,0,3,1,3,1,True,True
5603,117,36,0,0,2,0,2,0,True,False
5604,117,37,0,0,3,0,3,0,True,False
5605,117,38,0,1,5,1,5,0,True,False
5606,117,39,0,0,5,0,5,0,True,False
5607,117,40,0,0,2,2,2,2,True,True
5608,117,41,0,0,4,2,4,2,True,True
5609,117,42,0,0,4,1,4,1,True,True
5610,117,43,0,0,7,1,7,1,True,True
5611,117,44,1,0,1,2,0,2,False,True
5612,117,45,1,0,8,1,7,1,True,True
5613,117,46,0,0,8,1,8,1,True,True
5614,117,47,1,0,13,3,12,3,True,True
5615,117,48,0,0,6,3,6,3,True,True
5616,118,1,0,1,5,3,5,2,True,True
5617,118,2,0,0,7,2,7,2,True,True
5618,118,3,0,0,3,6,3,6,True,True
5619,118,4,0,0,11,6,11,6,True,True
5620,118,5,0,0,9,8,9,8,True,True
5621,118,6,0,0,5,4,5,4,True,True
5622,118,7,0,0,1,4,1,4,True,True
5623,118,8,0,1,2,6,2,5,True,True
5624,118,9,0,0,1,5,1,5,True,True
5625,118,10,1,0,1,5,0,5,False,True
5626,118,11,0,0,1,2,1,2,True,True
5627,118,12,1,0,1,0,0,0,False,False
5628,118,13,1,0,4,2,3,2,True,True
5629,118,14,0,0,2,2,2,2,True,True
5630,118,15,0,0,1,0,1,0,True,False
5631,118,16,1,0,1,0,0,0,False,False
5632,118,17,0,0,1,1,1,1,True,True
5633,118,18,1,0,3,0,2,0,True,False
5634,118,19,0,0,3,0,3,0,True,False
5635,118,20,0,0,4,1,4,1,True,True
5636,118,21,0,0,2,2,2,2,True,True
5637,118,22,0,0,1,2,1,2,True,True
5638,118,23,0,0,1,0,1,0,True,False
5639,118,24,0,0,1,1,1,1,True,True
5640,118,25,0,0,1,0,1,0,True,False
5641,118,26,0,0,2,1,2,1,True,True
5642,118,27,0,0,0,4,0,4,False,True
5643,118,28,0,1,2,0,2,-1,True,False
5644,118,29,0,0,5,2,5,2,True,True
5645,118,30,0,0,3,0,3,0,True,False
5646,118,31,0,0,0,5,0,5,False,True
5647,118,32,0,0,1,2,1,2,True,True
5648,118,33,0,0,0,2,0,2,False,True
5649,118,34,0,0,3,0,3,0,True,False
5650,118,35,0,0,2,0,2,0,True,False
5651,118,36,1,0,3,1,2,1,True,True
5652,118,37,1,0,3,4,2,4,True,True
5653,118,38,2,0,7,4,5,4,True,True
5654,118,39,2,0,9,2,7,2,True,True
5655,118,40,3,0,3,1,0,1,False,True
5656,118,41,2,0,8,1,6,1,True,True
5657,118,42,0,1,7,2,7,1,True,True
5658,118,43,2,0,4,0,2,0,True,False
5659,118,44,3,0,11,6,8,6,True,True
5660,118,45,2,0,9,0,7,0,True,False
5661,118,46,1,0,11,1,10,1,True,True
5662,118,47,0,0,13,2,13,2,True,True
5663,118,48,1,0,8,5,7,5,True,True
5664,119,1,2,2,47,35,45,33,True,True
5665,119,2,3,2,73,57,70,55,True,True
5666,119,3,2,4,39,43,37,39,True,True
5667,119,4,3,2,34,34,31,32,True,True
5668,119,5,3,4,40,33,37,29,True,True
5669,119,6,3,3,31,49,28,46,True,True
5670,119,7,0,3,24,36,24,33,True,True
5671,119,8,3,2,33,35,30,33,True,True
5672,119,9,3,5,30,41,27,36,True,True
5673,119,10,2,3,26,32,24,29,True,True
5674,119,11,2,6,17,33,15,27,True,True
5675,119,12,5,2,21,17,16,15,True,True
5676,119,13,4,4,20,19,16,15,True,True
5677,119,14,12,2,10,13,-2,11,False,True
5678,119,15,14,2,11,15,-3,13,False,True
5679,119,16,8,2,22,6,14,4,True,True
5680,119,17,4,4,11,6,7,2,True,True
5681,119,18,3,2,17,4,14,2,True,True
5682,119,19,4,0,9,12,5,12,True,True
5683,119,20,1,6,13,6,12,0,True,False
5684,119,21,1,0,11,3,10,3,True,True
5685,119,22,3,6,21,12,18,6,True,True
5686,119,23,3,2,18,10,15,8,True,True
5687,119,24,2,5,21,15,19,10,True,True
5688,119,25,5,0,21,13,16,13,True,True
5689,119,26,4,2,34,12,30,10,True,True
5690,119,27,2,5,25,12,23,7,True,True
5691,119,28,2,1,21,11,19,10,True,True
5692,119,29,4,0,30,17,26,17,True,True
5693,119,30,3,1,19,10,16,9,True,True
5694,119,31,1,0,14,9,13,9,True,True
5695,119,32,5,3,13,20,8,17,True,True
5696,119,33,2,4,8,14,6,10,True,True
5697,119,34,5,5,16,10,11,5,True,True
5698,119,35,1,4,9,11,8,7,True,True
5699,119,36,3,7,14,8,11,1,True,True
5700,119,37,8,3,24,16,16,13,True,True
5701,119,38,4,3,33,15,29,12,True,True
5702,119,39,4,3,46,19,42,16,True,True
5703,119,40,1,3,47,30,46,27,True,True
5704,119,41,2,1,44,20,42,19,True,True
5705,119,42,2,6,33,18,31,12,True,True
5706,119,43,10,2,24,15,14,13,True,True
5707,119,44,11,6,24,17,13,11,True,True
5708,119,45,9,6,34,25,25,19,True,True
5709,119,46,8,5,46,24,38,19,True,True
5710,119,47,6,5,50,24,44,19,True,True
5711,119,48,3,3,44,24,41,21,True,True
5712,120,1,1,1,13,7,12,6,True,True
5713,120,2,0,1,14,10,14,9,True,True
5714,120,3,2,3,15,15,13,12,True,True
5715,120,4,2,5,17,14,15,9,True,True
5716,120,5,1,3,11,15,10,12,True,True
5717,120,6,0,2,9,8,9,6,True,True
5718,120,7,0,1,9,17,9,16,True,True
5719,120,8,1,1,6,12,5,11,True,True
5720,120,9,8,2,10,11,2,9,True,True
5721,120,10,2,3,5,18,3,15,True,True
5722,120,11,0,1,5,3,5,2,True,True
5723,120,12,1,0,8,7,7,7,True,True
5724,120,13,0,0,3,6,3,6,True,True
5725,120,14,0,0,5,1,5,1,True,True
5726,120,15,3,1,3,3,0,2,False,True
5727,120,16,0,0,6,2,6,2,True,True
5728,120,17,2,0,11,3,9,3,True,True
5729,120,18,0,1,6,1,6,0,True,False
5730,120,19,0,0,7,2,7,2,True,True
5731,120,20,1,0,8,2,7,2,True,True
5732,120,21,0,0,3,0,3,0,True,False
5733,120,22,1,0,3,3,2,3,True,True
5734,120,23,0,0,2,1,2,1,True,True
5735,120,24,1,1,6,2,5,1,True,True
5736,120,25,0,1,1,2,1,1,True,True
5737,120,26,1,0,8,2,7,2,True,True
5738,120,27,1,0,6,1,5,1,True,True
5739,120,28,2,1,7,3,5,2,True,True
5740,120,29,0,0,2,2,2,2,True,True
5741,120,30,0,0,8,4,8,4,True,True
5742,120,31,0,0,7,3,7,3,True,True
5743,120,32,1,1,6,2,5,1,True,True
5744,120,33,1,0,4,5,3,5,True,True
5745,120,34,0,0,4,3,4,3,True,True
5746,120,35,0,0,4,4,4,4,True,True
5747,120,36,1,0,7,3,6,3,True,True
5748,120,37,2,1,5,4,3,3,True,True
5749,120,38,0,0,3,6,3,6,True,True
5750,120,39,0,0,8,2,8,2,True,True
5751,120,40,0,0,8,4,8,4,True,True
5752,120,41,1,1,6,2,5,1,True,True
5753,120,42,0,1,12,4,12,3,True,True
5754,120,43,0,5,19,7,19,2,True,True
5755,120,44,1,2,18,5,17,3,True,True
5756,120,45,1,0,13,8,12,8,True,True
5757,120,46,3,2,15,10,12,8,True,True
5758,120,47,3,2,21,7,18,5,True,True
5759,120,48,2,1,24,9,22,8,True,True
5760,121,1,3,0,59,27,56,27,True,True
5761,121,2,2,1,72,32,70,31,True,True
5762,121,3,2,3,80,31,78,28,True,True
5763,121,4,1,2,51,29,50,27,True,True
5764,121,5,1,1,42,30,41,29,True,True
5765,121,6,3,0,31,38,28,38,True,True
5766,121,7,1,2,20,50,19,48,True,True
5767,121,8,0,2,18,36,18,34,True,True
5768,121,9,3,2,21,33,18,31,True,True
5769,121,10,0,0,12,32,12,32,True,True
5770,121,11,1,1,14,30,13,29,True,True
5771,121,12,3,2,17,20,14,18,True,True
5772,121,13,2,1,15,24,13,23,True,True
5773,121,14,2,1,11,11,9,10,True,True
5774,121,15,0,0,13,6,13,6,True,True
5775,121,16,1,1,19,12,18,11,True,True
5776,121,17,4,0,26,5,22,5,True,True
5777,121,18,2,1,27,15,25,14,True,True
5778,121,19,4,2,24,10,20,8,True,True
5779,121,20,2,1,28,15,26,14,True,True
5780,121,21,4,3,18,11,14,8,True,True
5781,121,22,3,1,21,11,18,10,True,True
5782,121,23,7,1,23,10,16,9,True,True
5783,121,24,5,2,25,9,20,7,True,True
5784,121,25,4,2,31,11,27,9,True,True
5785,121,26,3,0,22,10,19,10,True,True
5786,121,27,0,1,23,13,23,12,True,True
5787,121,28,0,0,15,9,15,9,True,True
5788,121,29,3,2,24,17,21,15,True,True
5789,121,30,2,0,27,11,25,11,True,True
5790,121,31,3,0,24,9,21,9,True,True
5791,121,32,2,0,23,18,21,18,True,True
5792,121,33,1,0,34,12,33,12,True,True
5793,121,34,2,0,24,9,22,9,True,True
5794,121,35,1,0,16,9,15,9,True,True
5795,121,36,2,2,30,9,28,7,True,True
5796,121,37,0,1,26,14,26,13,True,True
5797,121,38,1,0,24,15,23,15,True,True
5798,121,39,3,0,42,15,39,15,True,True
5799,121,40,1,0,24,13,23,13,True,True
5800,121,41,1,2,39,10,38,8,True,True
5801,121,42,1,1,36,14,35,13,True,True
5802,121,43,0,2,51,15,51,13,True,True
5803,121,44,3,0,48,11,45,11,True,True
5804,121,45,3,0,54,23,51,23,True,True
5805,121,46,2,1,70,24,68,23,True,True
5806,121,47,1,1,53,14,52,13,True,True
5807,121,48,4,1,58,20,54,19,True,True
5808,122,1,1,0,20,3,19,3,True,True
5809,122,2,1,0,15,4,14,4,True,True
5810,122,3,1,1,10,5,9,4,True,True
5811,122,4,0,0,4,2,4,2,True,True
5812,122,5,0,0,2,1,2,1,True,True
5813,122,6,0,0,3,4,3,4,True,True
5814,122,7,1,0,4,0,3,0,True,False
5815,122,8,0,0,2,2,2,2,True,True
5816,122,9,1,0,2,6,1,6,True,True
5817,122,10,0,0,0,6,0,6,False,True
5818,122,11,0,0,0,5,0,5,False,True
5819,122,12,1,0,4,2,3,2,True,True
5820,122,13,0,0,0,1,0,1,False,True
5821,122,14,1,0,1,0,0,0,False,False
5822,122,15,2,0,5,0,3,0,True,False
5823,122,16,0,0,2,1,2,1,True,True
5824,122,17,0,0,2,2,2,2,True,True
5825,122,18,0,1,3,1,3,0,True,False
5826,122,19,1,1,2,1,1,0,True,False
5827,122,20,1,0,7,6,6,6,True,True
5828,122,21,0,0,3,2,3,2,True,True
5829,122,22,0,0,9,2,9,2,True,True
5830,122,23,0,0,3,1,3,1,True,True
5831,122,24,1,0,6,3,5,3,True,True
5832,122,25,0,0,4,1,4,1,True,True
5833,122,26,0,0,4,0,4,0,True,False
5834,122,27,0,0,7,2,7,2,True,True
5835,122,28,0,0,5,1,5,1,True,True
5836,122,29,0,0,7,6,7,6,True,True
5837,122,30,2,0,4,0,2,0,True,False
5838,122,31,0,0,5,2,5,2,True,True
5839,122,32,0,0,6,3,6,3,True,True
5840,122,33,0,0,6,1,6,1,True,True
5841,122,34,0,1,4,6,4,5,True,True
5842,122,35,0,0,1,1,1,1,True,True
5843,122,36,0,0,5,1,5,1,True,True
5844,122,37,0,0,3,6,3,6,True,True
5845,122,38,0,0,6,2,6,2,True,True
5846,122,39,1,0,4,1,3,1,True,True
5847,122,40,0,0,11,4,11,4,True,True
5848,122,41,0,0,6,2,6,2,True,True
5849,122,42,0,0,8,3,8,3,True,True
5850,122,43,0,0,9,1,9,1,True,True
5851,122,44,0,0,10,2,10,2,True,True
5852,122,45,0,0,15,3,15,3,True,True
5853,122,46,2,0,13,5,11,5,True,True
5854,122,47,0,0,14,1,14,1,True,True
5855,122,48,0,0,17,6,17,6,True,True
5856,123,1,1,1,51,26,50,25,True,True
5857,123,2,3,2,64,17,61,15,True,True
5858,123,3,2,3,53,23,51,20,True,True
5859,123,4,1,1,47,21,46,20,True,True
5860,123,5,2,0,49,32,47,32,True,True
5861,123,6,2,1,27,34,25,33,True,True
5862,123,7,3,3,18,40,15,37,True,True
5863,123,8,2,8,18,36,16,28,True,True
5864,123,9,1,4,14,38,13,34,True,True
5865,123,10,1,2,17,29,16,27,True,True
5866,123,11,3,3,13,23,10,20,True,True
5867,123,12,8,1,13,10,5,9,True,True
5868,123,13,3,3,9,14,6,11,True,True
5869,123,14,6,1,13,6,7,5,True,True
5870,123,15,2,3,8,6,6,3,True,True
5871,123,16,1,1,20,5,19,4,True,True
5872,123,17,3,1,19,2,16,1,True,True
5873,123,18,2,3,15,7,13,4,True,True
5874,123,19,6,2,23,5,17,3,True,True
5875,123,20,3,2,12,3,9,1,True,True
5876,123,21,3,2,14,6,11,4,True,True
5877,123,22,1,1,14,3,13,2,True,True
5878,123,23,3,0,11,6,8,6,True,True
5879,123,24,2,0,8,11,6,11,True,True
5880,123,25,1,1,11,5,10,4,True,True
5881,123,26,4,0,15,8,11,8,True,True
5882,123,27,0,0,14,9,14,9,True,True
5883,123,28,5,0,29,5,24,5,True,True
5884,123,29,2,0,25,9,23,9,True,True
5885,123,30,2,1,26,9,24,8,True,True
5886,123,31,0,2,23,14,23,12,True,True
5887,123,32,1,0,12,9,11,9,True,True
5888,123,33,3,0,15,7,12,7,True,True
5889,123,34,0,2,19,7,19,5,True,True
5890,123,35,0,2,12,2,12,0,True,False
5891,123,36,0,0,13,6,13,6,True,True
5892,123,37,0,0,27,5,27,5,True,True
5893,123,38,2,0,33,10,31,10,True,True
5894,123,39,0,0,30,11,30,11,True,True
5895,123,40,0,0,44,11,44,11,True,True
5896,123,41,1,0,47,13,46,13,True,True
5897,123,42,1,0,44,15,43,15,True,True
5898,123,43,0,1,36,12,36,11,True,True
5899,123,44,0,1,47,11,47,10,True,True
5900,123,45,1,0,59,11,58,11,True,True
5901,123,46,1,1,43,18,42,17,True,True
5902,123,47,2,0,61,10,59,10,True,True
5903,123,48,1,1,58,17,57,16,True,True
5904,124,1,0,1,28,13,28,12,True,True
5905,124,2,0,1,20,18,20,17,True,True
5906,124,3,0,1,21,8,21,7,True,True
5907,124,4,0,1,9,19,9,18,True,True
5908,124,5,1,4,16,17,15,13,True,True
5909,124,6,0,0,6,11,6,11,True,True
5910,124,7,0,1,12,15,12,14,True,True
5911,124,8,1,0,8,12,7,12,True,True
5912,124,9,2,0,11,18,9,18,True,True
5913,124,10,0,1,7,11,7,10,True,True
5914,124,11,0,2,8,10,8,8,True,True
5915,124,12,0,0,15,5,15,5,True,True
5916,124,13,0,0,9,10,9,10,True,True
5917,124,14,1,0,11,6,10,6,True,True
5918,124,15,0,0,2,10,2,10,True,True
5919,124,16,0,0,5,9,5,9,True,True
5920,124,17,0,0,10,3,10,3,True,True
5921,124,18,1,1,11,2,10,1,True,True
5922,124,19,0,0,16,7,16,7,True,True
5923,124,20,1,0,7,3,6,3,True,True
5924,124,21,0,2,8,4,8,2,True,True
5925,124,22,3,1,8,2,5,1,True,True
5926,124,23,0,1,8,0,8,-1,True,False
5927,124,24,1,0,4,5,3,5,True,True
5928,124,25,1,1,6,5,5,4,True,True
5929,124,26,1,0,9,5,8,5,True,True
5930,124,27,1,0,10,6,9,6,True,True
5931,124,28,1,1,15,7,14,6,True,True
5932,124,29,2,1,12,8,10,7,True,True
5933,124,30,2,1,25,8,23,7,True,True
5934,124,31,7,0,26,7,19,7,True,True
5935,124,32,3,2,25,12,22,10,True,True
5936,124,33,3,1,22,10,19,9,True,True
5937,124,34,4,2,21,7,17,5,True,True
5938,124,35,1,1,16,9,15,8,True,True
5939,124,36,5,0,17,9,12,9,True,True
5940,124,37,3,2,26,8,23,6,True,True
5941,124,38,3,1,22,13,19,12,True,True
5942,124,39,1,0,26,8,25,8,True,True
5943,124,40,1,0,21,12,20,12,True,True
5944,124,41,1,2,13,3,12,1,True,True
5945,124,42,0,1,20,9,20,8,True,True
5946,124,43,1,0,19,11,18,11,True,True
5947,124,44,2,0,32,9,30,9,True,True
5948,124,45,1,0,23,10,22,10,True,True
5949,124,46,1,1,32,13,31,12,True,True
5950,124,47,1,1,36,12,35,11,True,True
5951,124,48,2,0,30,19,28,19,True,True
5952,125,1,1359,1135,1117,1125,-242,-10,False,False
5953,125,2,1227,1175,983,1103,-244,-72,False,False
5954,125,3,1029,1321,831,939,-198,-382,False,False
5955,125,4,828,1308,600,792,-228,-516,False,False
5956,125,5,772,1303,482,616,-290,-687,False,False
5957,125,6,711,1195,357,482,-354,-713,False,False
5958,125,7,678,999,256,430,-422,-569,False,False
5959,125,8,658,876,185,312,-473,-564,False,False
5960,125,9,613,725,151,260,-462,-465,False,False
5961,125,10,252,317,132,155,-120,-162,False,False
5962,125,11,214,206,138,102,-76,-104,False,False
5963,125,12,292,116,167,69,-125,-47,False,False
5964,125,13,418,115,301,90,-117,-25,False,False
5965,125,14,816,106,502,77,-314,-29,False,False
5966,125,15,939,152,668,109,-271,-43,False,False
5967,125,16,1276,210,1048,161,-228,-49,False,False
5968,125,17,1480,171,1677,180,197,9,True,True
5969,125,18,1850,251,2528,274,678,23,True,True
5970,125,19,1722,312,3558,298,1836,-14,True,False
5971,125,20,1687,403,3673,350,1986,-53,True,False
5972,125,21,1532,392,2989,360,1457,-32,True,False
5973,125,22,1749,505,2317,407,568,-98,True,False
5974,125,23,1647,528,1983,424,336,-104,True,False
5975,125,24,1894,596,1758,483,-136,-113,False,False
5976,125,25,1959,578,1790,501,-169,-77,False,False
5977,125,26,1877,586,1732,497,-145,-89,False,False
5978,125,27,1662,629,1652,529,-10,-100,False,False
5979,125,28,1707,566,1739,506,32,-60,True,False
5980,125,29,1718,639,1632,523,-86,-116,False,False
5981,125,30,1663,556,1606,502,-57,-54,False,False
5982,125,31,1480,508,1408,428,-72,-80,False,False
5983,125,32,1295,518,1246,423,-49,-95,False,False
5984,125,33,921,458,1027,435,106,-23,True,False
5985,125,34,807,429,854,409,47,-20,True,False
5986,125,35,1003,449,929,431,-74,-18,False,False
5987,125,36,1233,570,987,481,-246,-89,False,False
5988,125,37,1562,622,1233,566,-329,-56,False,False
5989,125,38,1897,664,1530,635,-367,-29,False,False
5990,125,39,2321,722,1594,578,-727,-144,False,False
5991,125,40,2360,691,1667,681,-693,-10,False,False
5992,125,41,2330,588,1700,653,-630,65,False,True
5993,125,42,2230,613,1542,615,-688,2,False,True
5994,125,43,2079,596,1354,600,-725,4,False,True
5995,125,44,2049,615,1376,599,-673,-16,False,False
5996,125,45,2223,666,1357,625,-866,-41,False,False
5997,125,46,2063,725,1318,707,-745,-18,False,False
5998,125,47,1990,783,1317,891,-673,108,False,True
5999,125,48,1727,796,1311,967,-416,171,False,True
6000,126,1,1,0,38,16,37,16,True,True
6001,126,2,0,2,13,16,13,14,True,True
6002,126,3,1,5,26,23,25,18,True,True
6003,126,4,1,1,19,17,18,16,True,True
6004,126,5,2,2,12,20,10,18,True,True
6005,126,6,0,1,14,19,14,18,True,True
6006,126,7,3,0,20,16,17,16,True,True
6007,126,8,2,0,19,18,17,18,True,True
6008,126,9,1,3,12,17,11,14,True,True
6009,126,10,2,1,21,25,19,24,True,True
6010,126,11,0,2,11,16,11,14,True,True
6011,126,12,1,2,14,12,13,10,True,True
6012,126,13,2,1,35,5,33,4,True,True
6013,126,14,4,0,23,12,19,12,True,True
6014,126,15,4,0,21,9,17,9,True,True
6015,126,16,5,1,40,2,35,1,True,True
6016,126,17,6,0,26,3,20,3,True,True
6017,126,18,4,0,18,6,14,6,True,True
6018,126,19,4,0,18,3,14,3,True,True
6019,126,20,3,0,24,8,21,8,True,True
6020,126,21,2,0,17,7,15,7,True,True
6021,126,22,3,1,10,6,7,5,True,True
6022,126,23,1,1,11,4,10,3,True,True
6023,126,24,7,1,19,5,12,4,True,True
6024,126,25,6,2,18,7,12,5,True,True
6025,126,26,6,2,18,9,12,7,True,True
6026,126,27,3,2,14,5,11,3,True,True
6027,126,28,3,1,12,11,9,10,True,True
6028,126,29,3,1,17,8,14,7,True,True
6029,126,30,7,0,18,6,11,6,True,True
6030,126,31,8,2,15,6,7,4,True,True
6031,126,32,1,1,9,9,8,8,True,True
6032,126,33,2,0,8,9,6,9,True,True
6033,126,34,1,1,3,4,2,3,True,True
6034,126,35,0,1,3,7,3,6,True,True
6035,126,36,1,1,11,8,10,7,True,True
6036,126,37,1,0,10,6,9,6,True,True
6037,126,38,1,0,13,4,12,4,True,True
6038,126,39,0,1,11,4,11,3,True,True
6039,126,40,0,1,11,9,11,8,True,True
6040,126,41,3,1,18,4,15,3,True,True
6041,126,42,7,2,17,9,10,7,True,True
6042,126,43,4,0,14,5,10,5,True,True
6043,126,44,1,2,18,10,17,8,True,True
6044,126,45,5,1,20,12,15,11,True,True
6045,126,46,4,0,21,13,17,13,True,True
6046,126,47,2,0,20,11,18,11,True,True
6047,126,48,4,1,26,20,22,19,True,True
6048,127,1,37,35,349,168,312,133,True,True
6049,127,2,24,33,240,179,216,146,True,True
6050,127,3,27,39,239,203,212,164,True,True
6051,127,4,13,28,183,211,170,183,True,True
6052,127,5,10,29,155,226,145,197,True,True
6053,127,6,14,23,135,174,121,151,True,True
6054,127,7,11,16,97,182,86,166,True,True
6055,127,8,2,14,60,135,58,121,True,True
6056,127,9,3,18,57,111,54,93,True,True
6057,127,10,4,12,69,116,65,104,True,True
6058,127,11,1,6,41,68,40,62,True,True
6059,127,12,3,2,29,51,26,49,True,True
6060,127,13,5,2,16,25,11,23,True,True
6061,127,14,12,3,25,19,13,16,True,True
6062,127,15,15,2,36,23,21,21,True,True
6063,127,16,8,4,52,25,44,21,True,True
6064,127,17,12,4,47,23,35,19,True,True
6065,127,18,13,3,41,24,28,21,True,True
6066,127,19,6,3,26,29,20,26,True,True
6067,127,20,4,5,36,31,32,26,True,True
6068,127,21,10,3,34,17,24,14,True,True
6069,127,22,5,9,30,23,25,14,True,True
6070,127,23,4,2,56,35,52,33,True,True
6071,127,24,7,7,44,41,37,34,True,True
6072,127,25,7,4,36,39,29,35,True,True
6073,127,26,6,9,51,32,45,23,True,True
6074,127,27,8,4,54,25,46,21,True,True
6075,127,28,11,9,56,42,45,33,True,True
6076,127,29,10,8,53,41,43,33,True,True
6077,127,30,4,5,63,30,59,25,True,True
6078,127,31,11,2,63,38,52,36,True,True
6079,127,32,9,8,68,47,59,39,True,True
6080,127,33,8,3,54,42,46,39,True,True
6081,127,34,2,5,49,38,47,33,True,True
6082,127,35,2,3,53,36,51,33,True,True
6083,127,36,5,11,59,52,54,41,True,True
6084,127,37,6,6,82,51,76,45,True,True
6085,127,38,9,10,116,65,107,55,True,True
6086,127,39,10,14,118,62,108,48,True,True
6087,127,40,14,9,174,59,160,50,True,True
6088,127,41,14,5,216,56,202,51,True,True
6089,127,42,11,8,222,55,211,47,True,True
6090,127,43,26,14,223,68,197,54,True,True
6091,127,44,24,11,311,83,287,72,True,True
6092,127,45,28,10,307,95,279,85,True,True
6093,127,46,32,25,348,96,316,71,True,True
6094,127,47,36,37,381,128,345,91,True,True
6095,127,48,29,43,398,144,369,101,True,True
6096,128,1,2,1,12,5,10,4,True,True
6097,128,2,0,2,12,6,12,4,True,True
6098,128,3,1,2,13,2,12,0,True,False
6099,128,4,0,2,8,7,8,5,True,True
6100,128,5,0,3,6,7,6,4,True,True
6101,128,6,1,2,2,5,1,3,True,True
6102,128,7,0,1,6,4,6,3,True,True
6103,128,8,0,0,3,6,3,6,True,True
6104,128,9,0,0,2,8,2,8,True,True
6105,128,10,0,0,3,4,3,4,True,True
6106,128,11,0,0,2,1,2,1,True,True
6107,128,12,0,0,9,1,9,1,True,True
6108,128,13,0,0,6,0,6,0,True,False
6109,128,14,0,0,13,5,13,5,True,True
6110,128,15,2,0,12,8,10,8,True,True
6111,128,16,0,0,10,12,10,12,True,True
6112,128,17,3,0,16,12,13,12,True,True
6113,128,18,4,1,18,3,14,2,True,True
6114,128,19,0,0,23,4,23,4,True,True
6115,128,20,0,0,7,5,7,5,True,True
6116,128,21,0,0,6,4,6,4,True,True
6117,128,22,0,0,7,2,7,2,True,True
6118,128,23,0,0,8,5,8,5,True,True
6119,128,24,0,0,6,5,6,5,True,True
6120,128,25,0,0,8,6,8,6,True,True
6121,128,26,0,0,4,5,4,5,True,True
6122,128,27,2,1,6,3,4,2,True,True
6123,128,28,1,1,0,12,-1,11,False,True
6124,128,29,1,0,9,15,8,15,True,True
6125,128,30,1,0,7,12,6,12,True,True
6126,128,31,1,0,5,12,4,12,True,True
6127,128,32,1,1,5,13,4,12,True,True
6128,128,33,0,0,4,11,4,11,True,True
6129,128,34,0,0,1,6,1,6,True,True
6130,128,35,0,1,3,12,3,11,True,True
6131,128,36,0,0,4,11,4,11,True,True
6132,128,37,0,0,6,9,6,9,True,True
6133,128,38,0,1,12,9,12,8,True,True
6134,128,39,0,1,25,11,25,10,True,True
6135,128,40,1,2,29,6,28,4,True,True
6136,128,41,0,0,20,8,20,8,True,True
6137,128,42,0,1,27,13,27,12,True,True
6138,128,43,0,1,22,11,22,10,True,True
6139,128,44,2,1,22,4,20,3,True,True
6140,128,45,0,2,19,14,19,12,True,True
6141,128,46,2,2,17,12,15,10,True,True
6142,128,47,2,2,33,15,31,13,True,True
6143,128,48,2,2,16,6,14,4,True,True
6144,129,1,121,66,756,344,635,278,True,True
6145,129,2,139,94,826,514,687,420,True,True
6146,129,3,147,97,706,496,559,399,True,True
6147,129,4,140,104,657,519,517,415,True,True
6148,129,5,104,125,538,545,434,420,True,True
6149,129,6,109,99,464,525,355,426,True,True
6150,129,7,121,96,354,492,233,396,True,True
6151,129,8,114,108,251,401,137,293,True,True
6152,129,9,111,166,232,438,121,272,True,True
6153,129,10,127,135,252,396,125,261,True,True
6154,129,11,158,105,174,301,16,196,True,True
6155,129,12,216,107,135,192,-81,85,False,True
6156,129,13,132,102,136,158,4,56,True,True
6157,129,14,165,73,129,124,-36,51,False,True
6158,129,15,166,86,143,97,-23,11,False,True
6159,129,16,132,96,148,108,16,12,True,True
6160,129,17,107,91,168,104,61,13,True,True
6161,129,18,103,92,162,120,59,28,True,True
6162,129,19,86,82,145,123,59,41,True,True
6163,129,20,45,82,132,117,87,35,True,True
6164,129,21,56,86,145,118,89,32,True,True
6165,129,22,66,72,183,119,117,47,True,True
6166,129,23,57,56,160,102,103,46,True,True
6167,129,24,58,57,135,111,77,54,True,True
6168,129,25,49,48,172,97,123,49,True,True
6169,129,26,54,54,140,95,86,41,True,True
6170,129,27,52,38,195,111,143,73,True,True
6171,129,28,40,36,167,114,127,78,True,True
6172,129,29,44,39,172,93,128,54,True,True
6173,129,30,54,34,217,111,163,77,True,True
6174,129,31,51,25,216,92,165,67,True,True
6175,129,32,50,42,209,113,159,71,True,True
6176,129,33,56,41,206,115,150,74,True,True
6177,129,34,73,45,190,101,117,56,True,True
6178,129,35,83,42,194,97,111,55,True,True
6179,129,36,67,31,200,116,133,85,True,True
6180,129,37,53,32,226,118,173,86,True,True
6181,129,38,38,41,203,131,165,90,True,True
6182,129,39,58,34,244,127,186,93,True,True
6183,129,40,45,28,276,122,231,94,True,True
6184,129,41,47,36,297,138,250,102,True,True
6185,129,42,60,29,363,154,303,125,True,True
6186,129,43,70,35,450,134,380,99,True,True
6187,129,44,76,43,494,171,418,128,True,True
6188,129,45,56,51,578,197,522,146,True,True
6189,129,46,75,55,575,213,500,158,True,True
6190,129,47,100,55,684,301,584,246,True,True
6191,129,48,110,94,738,369,628,275,True,True
6192,130,1,7,7,79,38,72,31,True,True
6193,130,2,6,1,68,35,62,34,True,True
6194,130,3,10,4,68,33,58,29,True,True
6195,130,4,10,1,44,30,34,29,True,True
6196,130,5,6,1,38,18,32,17,True,True
6197,130,6,6,2,40,29,34,27,True,True
6198,130,7,6,3,19,31,13,28,True,True
6199,130,8,2,0,13,23,11,23,True,True
6200,130,9,2,2,18,38,16,36,True,True
6201,130,10,2,3,18,31,16,28,True,True
6202,130,11,3,3,16,15,13,12,True,True
6203,130,12,4,3,7,14,3,11,True,True
6204,130,13,17,7,18,13,1,6,True,True
6205,130,14,20,5,12,16,-8,11,False,True
6206,130,15,18,9,34,17,16,8,True,True
6207,130,16,16,4,28,19,12,15,True,True
6208,130,17,16,1,54,14,38,13,True,True
6209,130,18,18,11,28,15,10,4,True,True
6210,130,19,16,2,64,30,48,28,True,True
6211,130,20,13,3,58,19,45,16,True,True
6212,130,21,18,6,42,26,24,20,True,True
6213,130,22,9,5,47,36,38,31,True,True
6214,130,23,23,11,30,25,7,14,True,True
6215,130,24,20,3,45,20,25,17,True,True
6216,130,25,25,10,30,24,5,14,True,True
6217,130,26,8,6,33,14,25,8,True,True
6218,130,27,21,4,46,17,25,13,True,True
6219,130,28,16,8,38,17,22,9,True,True
6220,130,29,22,10,42,16,20,6,True,True
6221,130,30,16,16,34,23,18,7,True,True
6222,130,31,21,14,41,17,20,3,True,True
6223,130,32,25,8,48,15,23,7,True,True
6224,130,33,21,10,51,30,30,20,True,True
6225,130,34,25,24,42,25,17,1,True,True
6226,130,35,25,18,32,21,7,3,True,True
6227,130,36,23,6,51,20,28,14,True,True
6228,130,37,22,12,49,23,27,11,True,True
6229,130,38,27,11,32,24,5,13,True,True
6230,130,39,14,10,52,18,38,8,True,True
6231,130,40,16,7,39,28,23,21,True,True
6232,130,41,13,7,59,12,46,5,True,True
6233,130,42,15,11,32,21,17,10,True,True
6234,130,43,17,12,47,29,30,17,True,True
6235,130,44,9,9,62,29,53,20,True,True
6236,130,45,11,9,61,29,50,20,True,True
6237,130,46,6,8,72,27,66,19,True,True
6238,130,47,4,7,79,33,75,26,True,True
6239,130,48,9,7,82,39,73,32,True,True
6240,131,1,1,0,49,25,48,25,True,True
6241,131,2,1,1,58,17,57,16,True,True
6242,131,3,1,0,61,26,60,26,True,True
6243,131,4,0,0,36,29,36,29,True,True
6244,131,5,3,1,32,20,29,19,True,True
6245,131,6,1,0,18,25,17,25,True,True
6246,131,7,0,0,15,25,15,25,True,True
6247,131,8,2,1,10,30,8,29,True,True
6248,131,9,0,3,10,18,10,15,True,True
6249,131,10,0,1,10,14,10,13,True,True
6250,131,11,0,3,9,20,9,17,True,True
6251,131,12,2,1,12,12,10,11,True,True
6252,131,13,0,0,18,13,18,13,True,True
6253,131,14,5,0,20,5,15,5,True,True
6254,131,15,0,1,12,9,12,8,True,True
6255,131,16,0,0,10,7,10,7,True,True
6256,131,17,2,0,23,7,21,7,True,True
6257,131,18,0,2,12,6,12,4,True,True
6258,131,19,1,0,15,6,14,6,True,True
6259,131,20,3,0,11,11,8,11,True,True
6260,131,21,2,0,13,4,11,4,True,True
6261,131,22,1,1,10,5,9,4,True,True
6262,131,23,3,1,10,8,7,7,True,True
6263,131,24,1,0,7,7,6,7,True,True
6264,131,25,2,1,11,8,9,7,True,True
6265,131,26,0,0,7,9,7,9,True,True
6266,131,27,0,0,16,10,16,10,True,True
6267,131,28,0,0,10,5,10,5,True,True
6268,131,29,1,3,13,11,12,8,True,True
6269,131,30,1,1,17,13,16,12,True,True
6270,131,31,0,0,11,7,11,7,True,True
6271,131,32,3,0,18,10,15,10,True,True
6272,131,33,1,2,19,9,18,7,True,True
6273,131,34,2,0,19,10,17,10,True,True
6274,131,35,2,0,19,11,17,11,True,True
6275,131,36,1,4,18,15,17,11,True,True
6276,131,37,0,0,21,10,21,10,True,True
6277,131,38,1,0,29,5,28,5,True,True
6278,131,39,1,2,23,9,22,7,True,True
6279,131,40,0,2,40,6,40,4,True,True
6280,131,41,3,0,33,14,30,14,True,True
6281,131,42,1,0,45,7,44,7,True,True
6282,131,43,1,0,42,10,41,10,True,True
6283,131,44,0,0,50,15,50,15,True,True
6284,131,45,0,0,41,19,41,19,True,True
6285,131,46,1,1,49,12,48,11,True,True
6286,131,47,0,0,65,12,65,12,True,True
6287,131,48,1,1,56,20,55,19,True,True
6288,132,1,4121,1476,212,75,-3909,-1401,False,False
6289,132,2,4138,1304,161,84,-3977,-1220,False,False
6290,132,3,3390,1012,154,45,-3236,-967,False,False
6291,132,4,1753,632,98,33,-1655,-599,False,False
6292,132,5,983,364,64,25,-919,-339,False,False
6293,132,6,446,235,56,34,-390,-201,False,False
6294,132,7,232,209,84,32,-148,-177,False,False
6295,132,8,128,215,155,97,27,-118,True,False
6296,132,9,178,185,446,180,268,-5,True,False
6297,132,10,267,184,979,363,712,179,True,True
6298,132,11,1200,362,1689,646,489,284,True,True
6299,132,12,2757,904,2452,977,-305,73,False,True
6300,132,13,3071,1406,2198,968,-873,-438,False,False
6301,132,14,2875,1178,2608,1103,-267,-75,False,False
6302,132,15,3688,1350,2382,1111,-1306,-239,False,False
6303,132,16,3682,1452,1976,1052,-1706,-400,False,False
6304,132,17,3500,1289,1819,993,-1681,-296,False,False
6305,132,18,2885,1164,1620,861,-1265,-303,False,False
6306,132,19,1854,707,1610,754,-244,47,False,True
6307,132,20,1893,714,1224,705,-669,-9,False,False
6308,132,21,1916,739,1312,732,-604,-7,False,False
6309,132,22,1722,627,1590,757,-132,130,False,True
6310,132,23,2224,1012,1524,723,-700,-289,False,False
6311,132,24,2784,1263,1630,869,-1154,-394,False,False
6312,132,25,2594,1128,1854,939,-740,-189,False,False
6313,132,26,2894,1272,2073,1047,-821,-225,False,False
6314,132,27,3830,1849,2215,1059,-1615,-790,False,False
6315,132,28,4503,2263,2422,1251,-2081,-1012,False,False
6316,132,29,4442,2113,2818,1444,-1624,-669,False,False
6317,132,30,4482,2388,3126,1601,-1356,-787,False,False
6318,132,31,4806,2370,3348,1770,-1458,-600,False,False
6319,132,32,5142,2654,3094,1826,-2048,-828,False,False
6320,132,33,5068,2558,3368,2016,-1700,-542,False,False
6321,132,34,4748,2407,3097,1777,-1651,-630,False,False
6322,132,35,4806,2640,2649,1756,-2157,-884,False,False
6323,132,36,5157,2666,2404,1697,-2753,-969,False,False
6324,132,37,5007,2806,2270,1576,-2737,-1230,False,False
6325,132,38,4842,2458,2443,1467,-2399,-991,False,False
6326,132,39,4402,2280,2360,1195,-2042,-1085,False,False
6327,132,40,4540,2432,2001,924,-2539,-1508,False,False
6328,132,41,4613,2636,1609,716,-3004,-1920,False,False
6329,132,42,4792,2776,1259,568,-3533,-2208,False,False
6330,132,43,4871,2730,1010,452,-3861,-2278,False,False
6331,132,44,4645,2445,786,315,-3859,-2130,False,False
6332,132,45,4893,2553,489,219,-4404,-2334,False,False
6333,132,46,4784,2401,394,177,-4390,-2224,False,False
6334,132,47,4402,2200,345,118,-4057,-2082,False,False
6335,132,48,4228,2298,272,114,-3956,-2184,False,False
6336,133,1,15,7,170,75,155,68,True,True
6337,133,2,14,6,186,81,172,75,True,True
6338,133,3,8,5,145,115,137,110,True,True
6339,133,4,13,10,126,118,113,108,True,True
6340,133,5,6,10,88,113,82,103,True,True
6341,133,6,4,3,73,119,69,116,True,True
6342,133,7,6,7,75,107,69,100,True,True
6343,133,8,3,8,45,94,42,86,True,True
6344,133,9,4,16,40,96,36,80,True,True
6345,133,10,14,10,46,88,32,78,True,True
6346,133,11,7,7,23,42,16,35,True,True
6347,133,12,24,9,17,32,-7,23,False,True
6348,133,13,30,5,18,22,-12,17,False,True
6349,133,14,26,7,15,12,-11,5,False,True
6350,133,15,27,2,16,8,-11,6,False,True
6351,133,16,26,7,15,5,-11,-2,False,False
6352,133,17,39,6,26,16,-13,10,False,True
6353,133,18,26,8,16,12,-10,4,False,True
6354,133,19,13,2,14,8,1,6,True,True
6355,133,20,16,5,12,6,-4,1,False,True
6356,133,21,9,5,20,13,11,8,True,True
6357,133,22,11,5,18,7,7,2,True,True
6358,133,23,13,6,13,8,0,2,False,True
6359,133,24,12,7,26,11,14,4,True,True
6360,133,25,7,2,14,11,7,9,True,True
6361,133,26,6,3,17,12,11,9,True,True
6362,133,27,2,5,27,8,25,3,True,True
6363,133,28,5,5,23,11,18,6,True,True
6364,133,29,11,6,32,11,21,5,True,True
6365,133,30,6,5,30,21,24,16,True,True
6366,133,31,11,2,34,12,23,10,True,True
6367,133,32,1,2,19,18,18,16,True,True
6368,133,33,2,6,15,15,13,9,True,True
6369,133,34,15,12,25,15,10,3,True,True
6370,133,35,21,11,26,24,5,13,True,True
6371,133,36,12,13,21,24,9,11,True,True
6372,133,37,9,9,46,31,37,22,True,True
6373,133,38,7,4,39,21,32,17,True,True
6374,133,39,10,6,52,27,42,21,True,True
6375,133,40,9,7,57,22,48,15,True,True
6376,133,41,7,7,69,24,62,17,True,True
6377,133,42,3,8,71,31,68,23,True,True
6378,133,43,11,10,112,40,101,30,True,True
6379,133,44,8,8,153,37,145,29,True,True
6380,133,45,15,8,138,50,123,42,True,True
6381,133,46,15,5,141,42,126,37,True,True
6382,133,47,11,6,159,54,148,48,True,True
6383,133,48,9,9,170,80,161,71,True,True
6384,134,1,9,5,106,54,97,49,True,True
6385,134,2,15,4,115,43,100,39,True,True
6386,134,3,10,6,94,42,84,36,True,True
6387,134,4,8,10,71,63,63,53,True,True
6388,134,5,3,2,47,54,44,52,True,True
6389,134,6,8,5,48,64,40,59,True,True
6390,134,7,1,5,31,54,30,49,True,True
6391,134,8,6,4,23,48,17,44,True,True
6392,134,9,3,5,36,50,33,45,True,True
6393,134,10,5,4,21,36,16,32,True,True
6394,134,11,4,6,18,30,14,24,True,True
6395,134,12,8,0,28,20,20,20,True,True
6396,134,13,20,3,31,25,11,22,True,True
6397,134,14,26,12,29,9,3,-3,True,False
6398,134,15,28,7,28,16,0,9,False,True
6399,134,16,18,9,13,9,-5,0,False,False
6400,134,17,14,5,35,10,21,5,True,True
6401,134,18,12,4,25,12,13,8,True,True
6402,134,19,6,5,27,15,21,10,True,True
6403,134,20,12,9,25,7,13,-2,True,False
6404,134,21,13,6,18,8,5,2,True,True
6405,134,22,15,4,28,6,13,2,True,True
6406,134,23,7,3,30,8,23,5,True,True
6407,134,24,5,4,18,11,13,7,True,True
6408,134,25,5,2,25,9,20,7,True,True
6409,134,26,4,4,19,15,15,11,True,True
6410,134,27,14,2,24,10,10,8,True,True
6411,134,28,8,2,24,13,16,11,True,True
6412,134,29,10,5,33,11,23,6,True,True
6413,134,30,17,6,40,14,23,8,True,True
6414,134,31,22,4,48,23,26,19,True,True
6415,134,32,22,4,32,21,10,17,True,True
6416,134,33,13,7,34,15,21,8,True,True
6417,134,34,13,7,41,12,28,5,True,True
6418,134,35,0,5,34,11,34,6,True,True
6419,134,36,8,3,36,20,28,17,True,True
6420,134,37,5,3,30,20,25,17,True,True
6421,134,38,6,3,28,22,22,19,True,True
6422,134,39,12,5,47,30,35,25,True,True
6423,134,40,5,3,40,13,35,10,True,True
6424,134,41,5,5,48,18,43,13,True,True
6425,134,42,5,5,59,17,54,12,True,True
6426,134,43,14,3,62,26,48,23,True,True
6427,134,44,7,1,93,16,86,15,True,True
6428,134,45,17,6,90,32,73,26,True,True
6429,134,46,9,4,118,35,109,31,True,True
6430,134,47,8,10,104,29,96,19,True,True
6431,134,48,16,3,126,32,110,29,True,True
6432,135,1,0,3,83,26,83,23,True,True
6433,135,2,4,1,77,27,73,26,True,True
6434,135,3,0,2,70,31,70,29,True,True
6435,135,4,3,1,58,32,55,31,True,True
6436,135,5,0,5,48,43,48,38,True,True
6437,135,6,1,2,39,50,38,48,True,True
6438,135,7,1,1,24,46,23,45,True,True
6439,135,8,2,5,22,28,20,23,True,True
6440,135,9,1,2,18,34,17,32,True,True
6441,135,10,10,5,14,23,4,18,True,True
6442,135,11,2,1,11,19,9,18,True,True
6443,135,12,5,3,15,17,10,14,True,True
6444,135,13,6,0,17,15,11,15,True,True
6445,135,14,5,1,20,14,15,13,True,True
6446,135,15,6,2,24,12,18,10,True,True
6447,135,16,14,7,33,10,19,3,True,True
6448,135,17,12,5,27,15,15,10,True,True
6449,135,18,5,3,39,22,34,19,True,True
6450,135,19,9,0,28,23,19,23,True,True
6451,135,20,6,5,31,16,25,11,True,True
6452,135,21,4,8,24,15,20,7,True,True
6453,135,22,6,4,28,12,22,8,True,True
6454,135,23,6,1,28,6,22,5,True,True
6455,135,24,4,0,22,8,18,8,True,True
6456,135,25,2,1,28,9,26,8,True,True
6457,135,26,2,0,23,9,21,9,True,True
6458,135,27,1,0,22,7,21,7,True,True
6459,135,28,4,1,32,11,28,10,True,True
6460,135,29,4,1,32,11,28,10,True,True
6461,135,30,1,0,25,14,24,14,True,True
6462,135,31,4,1,30,11,26,10,True,True
6463,135,32,6,2,30,17,24,15,True,True
6464,135,33,3,2,33,17,30,15,True,True
6465,135,34,2,3,34,15,32,12,True,True
6466,135,35,2,0,26,13,24,13,True,True
6467,135,36,2,2,30,10,28,8,True,True
6468,135,37,0,1,35,17,35,16,True,True
6469,135,38,3,1,52,16,49,15,True,True
6470,135,39,0,2,44,7,44,5,True,True
6471,135,40,4,1,46,19,42,18,True,True
6472,135,41,3,2,32,15,29,13,True,True
6473,135,42,6,1,65,20,59,19,True,True
6474,135,43,3,0,64,16,61,16,True,True
6475,135,44,3,1,76,20,73,19,True,True
6476,135,45,0,0,72,20,72,20,True,True
6477,135,46,1,1,83,18,82,17,True,True
6478,135,47,1,0,82,15,81,15,True,True
6479,135,48,2,1,103,33,101,32,True,True
6480,136,1,0,1,28,14,28,13,True,True
6481,136,2,1,1,40,20,39,19,True,True
6482,136,3,1,2,31,32,30,30,True,True
6483,136,4,3,3,28,35,25,32,True,True
6484,136,5,2,1,19,32,17,31,True,True
6485,136,6,0,5,37,33,37,28,True,True
6486,136,7,0,1,22,30,22,29,True,True
6487,136,8,0,1,13,33,13,32,True,True
6488,136,9,2,1,17,33,15,32,True,True
6489,136,10,1,1,15,24,14,23,True,True
6490,136,11,1,2,6,16,5,14,True,True
6491,136,12,0,2,8,17,8,15,True,True
6492,136,13,1,3,12,9,11,6,True,True
6493,136,14,0,0,10,7,10,7,True,True
6494,136,15,0,0,11,6,11,6,True,True
6495,136,16,0,2,13,10,13,8,True,True
6496,136,17,2,0,24,9,22,9,True,True
6497,136,18,0,1,15,6,15,5,True,True
6498,136,19,0,1,11,3,11,2,True,True
6499,136,20,0,0,16,5,16,5,True,True
6500,136,21,0,2,8,1,8,-1,True,False
6501,136,22,0,0,12,10,12,10,True,True
6502,136,23,0,0,8,5,8,5,True,True
6503,136,24,0,0,4,7,4,7,True,True
6504,136,25,0,0,14,6,14,6,True,True
6505,136,26,1,1,4,2,3,1,True,True
6506,136,27,0,0,14,8,14,8,True,True
6507,136,28,1,1,11,5,10,4,True,True
6508,136,29,1,0,10,5,9,5,True,True
6509,136,30,0,1,12,8,12,7,True,True
6510,136,31,1,1,10,9,9,8,True,True
6511,136,32,2,0,10,8,8,8,True,True
6512,136,33,1,0,8,5,7,5,True,True
6513,136,34,1,0,7,4,6,4,True,True
6514,136,35,3,0,11,2,8,2,True,True
6515,136,36,1,2,9,4,8,2,True,True
6516,136,37,2,0,10,6,8,6,True,True
6517,136,38,3,0,14,6,11,6,True,True
6518,136,39,2,1,21,10,19,9,True,True
6519,136,40,3,0,17,8,14,8,True,True
6520,136,41,2,1,27,19,25,18,True,True
6521,136,42,5,1,22,4,17,3,True,True
6522,136,43,2,1,22,15,20,14,True,True
6523,136,44,3,1,36,12,33,11,True,True
6524,136,45,3,3,39,6,36,3,True,True
6525,136,46,4,0,28,15,24,15,True,True
6526,136,47,3,0,27,14,24,14,True,True
6527,136,48,6,1,38,25,32,24,True,True
6528,137,1,2405,2582,2669,2005,264,-577,True,False
6529,137,2,1646,2441,2125,2019,479,-422,True,False
6530,137,3,1134,1920,1434,2096,300,176,True,True
6531,137,4,763,1655,1112,2193,349,538,True,True
6532,137,5,677,1230,871,2228,194,998,True,True
6533,137,6,632,1091,649,2046,17,955,True,True
6534,137,7,357,973,506,1917,149,944,True,True
6535,137,8,354,849,396,1459,42,610,True,True
6536,137,9,388,769,357,1123,-31,354,False,True
6537,137,10,397,615,288,646,-109,31,False,True
6538,137,11,485,394,373,421,-112,27,False,True
6539,137,12,860,332,719,300,-141,-32,False,False
6540,137,13,1314,318,1238,276,-76,-42,False,False
6541,137,14,2673,391,2301,462,-372,71,False,True
6542,137,15,3353,528,2586,489,-767,-39,False,False
6543,137,16,4278,676,3522,690,-756,14,False,True
6544,137,17,4238,730,3350,528,-888,-202,False,False
6545,137,18,3741,922,2989,553,-752,-369,False,False
6546,137,19,3360,954,2919,609,-441,-345,False,False
6547,137,20,3122,1251,2690,812,-432,-439,False,False
6548,137,21,2962,1228,2509,857,-453,-371,False,False
6549,137,22,2845,1493,2606,915,-239,-578,False,False
6550,137,23,2698,1438,2370,1012,-328,-426,False,False
6551,137,24,2769,1520,2367,1156,-402,-364,False,False
6552,137,25,2659,1541,2310,1205,-349,-336,False,False
6553,137,26,2591,1547,2432,1229,-159,-318,False,False
6554,137,27,2385,1371,2575,1315,190,-56,True,False
6555,137,28,2453,1362,2649,1277,196,-85,True,False
6556,137,29,2530,1311,2614,1349,84,38,True,True
6557,137,30,2645,1256,2583,1387,-62,131,False,True
6558,137,31,2600,1270,2590,1452,-10,182,False,True
6559,137,32,2323,1308,2409,1494,86,186,True,True
6560,137,33,1968,1196,2081,1481,113,285,True,True
6561,137,34,1840,1142,1820,1302,-20,160,False,True
6562,137,35,2333,1195,1903,1332,-430,137,False,True
6563,137,36,3117,1372,2668,1631,-449,259,False,True
6564,137,37,3787,1466,3302,1833,-485,367,False,True
6565,137,38,3993,1641,3762,1851,-231,210,False,True
6566,137,39,4151,1626,4015,1833,-136,207,False,True
6567,137,40,4219,1645,4159,1876,-60,231,False,True
6568,137,41,4207,1616,4015,1773,-192,157,False,True
6569,137,42,3913,1692,4018,1711,105,19,True,True
6570,137,43,3845,1726,4392,1825,547,99,True,True
6571,137,44,3697,1709,4490,2036,793,327,True,True
6572,137,45,3751,1835,4507,1938,756,103,True,True
6573,137,46,3233,1868,4448,2107,1215,239,True,True
6574,137,47,3333,1999,4049,1940,716,-59,True,False
6575,137,48,2996,1989,3723,1732,727,-257,True,False
6576,138,1,4971,1521,80,50,-4891,-1471,False,False
6577,138,2,3712,875,64,34,-3648,-841,False,False
6578,138,3,2097,515,70,40,-2027,-475,False,False
6579,138,4,1477,372,67,30,-1410,-342,False,False
6580,138,5,1073,286,56,23,-1017,-263,False,False
6581,138,6,557,90,42,28,-515,-62,False,False
6582,138,7,293,54,109,67,-184,13,False,True
6583,138,8,37,12,315,163,278,151,True,True
6584,138,9,40,21,1160,540,1120,519,True,True
6585,138,10,102,31,3194,1050,3092,1019,True,True
6586,138,11,135,53,4523,1136,4388,1083,True,True
6587,138,12,167,58,4720,1227,4553,1169,True,True
6588,138,13,170,61,4959,1287,4789,1226,True,True
6589,138,14,358,60,5178,1338,4820,1278,True,True
6590,138,15,2346,83,5010,1547,2664,1464,True,True
6591,138,16,3698,246,4613,1706,915,1460,True,True
6592,138,17,4772,243,4234,1857,-538,1614,False,True
6593,138,18,3617,801,4253,1880,636,1079,True,True
6594,138,19,7150,1404,3857,1877,-3293,473,False,True
6595,138,20,6537,1430,4278,1948,-2259,518,False,True
6596,138,21,6805,1940,3923,1782,-2882,-158,False,False
6597,138,22,7510,2370,4082,1696,-3428,-674,False,False
6598,138,23,7234,2335,3777,1755,-3457,-580,False,False
6599,138,24,6073,1999,4392,1758,-1681,-241,False,False
6600,138,25,6470,2222,4271,1900,-2199,-322,False,False
6601,138,26,6567,2492,5008,1880,-1559,-612,False,False
6602,138,27,6758,2489,5078,1986,-1680,-503,False,False
6603,138,28,6046,2540,5739,1970,-307,-570,False,False
6604,138,29,7403,3076,5297,1891,-2106,-1185,False,False
6605,138,30,6564,2651,5642,1924,-922,-727,False,False
6606,138,31,6833,2601,5260,1729,-1573,-872,False,False
6607,138,32,6356,2712,5267,1861,-1089,-851,False,False
6608,138,33,6542,2849,5317,1685,-1225,-1164,False,False
6609,138,34,6525,2614,4545,1654,-1980,-960,False,False
6610,138,35,7443,3120,3999,1404,-3444,-1716,False,False
6611,138,36,6731,3037,3580,1407,-3151,-1630,False,False
6612,138,37,6664,2939,3533,1213,-3131,-1726,False,False
6613,138,38,6959,3207,2727,892,-4232,-2315,False,False
6614,138,39,7140,2883,1859,616,-5281,-2267,False,False
6615,138,40,6211,2566,1311,472,-4900,-2094,False,False
6616,138,41,6241,2695,826,299,-5415,-2396,False,False
6617,138,42,6546,2854,503,199,-6043,-2655,False,False
6618,138,43,7094,3138,355,116,-6739,-3022,False,False
6619,138,44,6938,3218,255,92,-6683,-3126,False,False
6620,138,45,7218,3188,164,66,-7054,-3122,False,False
6621,138,46,6426,2919,157,64,-6269,-2855,False,False
6622,138,47,6740,3129,160,59,-6580,-3070,False,False
6623,138,48,6770,3291,113,32,-6657,-3259,False,False
6624,139,1,1,0,12,11,11,11,True,True
6625,139,2,0,0,10,12,10,12,True,True
6626,139,3,1,1,16,11,15,10,True,True
6627,139,4,0,0,13,4,13,4,True,True
6628,139,5,1,0,6,0,5,0,True,False
6629,139,6,1,0,8,6,7,6,True,True
6630,139,7,2,2,7,3,5,1,True,True
6631,139,8,1,0,3,5,2,5,True,True
6632,139,9,0,0,1,5,1,5,True,True
6633,139,10,1,0,5,2,4,2,True,True
6634,139,11,1,0,4,3,3,3,True,True
6635,139,12,0,1,3,4,3,3,True,True
6636,139,13,0,0,3,1,3,1,True,True
6637,139,14,0,0,7,1,7,1,True,True
6638,139,15,0,0,5,4,5,4,True,True
6639,139,16,0,0,9,7,9,7,True,True
6640,139,17,0,0,4,2,4,2,True,True
6641,139,18,1,0,10,6,9,6,True,True
6642,139,19,1,0,7,3,6,3,True,True
6643,139,20,1,0,6,4,5,4,True,True
6644,139,21,0,0,3,4,3,4,True,True
6645,139,22,1,0,5,1,4,1,True,True
6646,139,23,0,0,5,3,5,3,True,True
6647,139,24,0,0,7,1,7,1,True,True
6648,139,25,2,0,1,8,-1,8,False,True
6649,139,26,0,0,15,2,15,2,True,True
6650,139,27,1,1,3,5,2,4,True,True
6651,139,28,0,1,9,4,9,3,True,True
6652,139,29,0,1,6,4,6,3,True,True
6653,139,30,0,0,9,6,9,6,True,True
6654,139,31,1,1,7,7,6,6,True,True
6655,139,32,0,0,14,3,14,3,True,True
6656,139,33,2,0,11,3,9,3,True,True
6657,139,34,0,0,9,1,9,1,True,True
6658,139,35,2,0,10,5,8,5,True,True
6659,139,36,0,0,7,2,7,2,True,True
6660,139,37,0,0,8,2,8,2,True,True
6661,139,38,0,0,8,4,8,4,True,True
6662,139,39,0,0,12,5,12,5,True,True
6663,139,40,0,0,15,7,15,7,True,True
6664,139,41,0,0,15,5,15,5,True,True
6665,139,42,1,0,11,4,10,4,True,True
6666,139,43,1,0,16,5,15,5,True,True
6667,139,44,1,0,24,6,23,6,True,True
6668,139,45,0,0,13,6,13,6,True,True
6669,139,46,0,0,23,6,23,6,True,True
6670,139,47,1,0,13,3,12,3,True,True
6671,139,48,0,0,13,9,13,9,True,True
6672,140,1,1221,1173,2294,1517,1073,344,True,True
6673,140,2,811,810,1715,1536,904,726,True,True
6674,140,3,583,602,1179,1431,596,829,True,True
6675,140,4,407,546,874,1381,467,835,True,True
6676,140,5,330,504,710,1319,380,815,True,True
6677,140,6,263,388,506,1205,243,817,True,True
6678,140,7,212,332,403,1010,191,678,True,True
6679,140,8,247,255,311,822,64,567,True,True
6680,140,9,284,303,340,709,56,406,True,True
6681,140,10,393,256,354,492,-39,236,False,True
6682,140,11,561,269,374,347,-187,78,False,True
6683,140,12,1054,258,1040,295,-14,37,False,True
6684,140,13,1710,302,1805,312,95,10,True,True
6685,140,14,3104,413,4056,688,952,275,True,True
6686,140,15,4651,629,4611,880,-40,251,False,True
6687,140,16,6314,1054,5104,702,-1210,-352,False,False
6688,140,17,7307,954,5430,604,-1877,-350,False,False
6689,140,18,7376,1124,5590,582,-1786,-542,False,False
6690,140,19,6776,1203,5319,737,-1457,-466,False,False
6691,140,20,6169,1414,4884,863,-1285,-551,False,False
6692,140,21,5320,1647,4574,978,-746,-669,False,False
6693,140,22,5319,1720,4769,1027,-550,-693,False,False
6694,140,23,4927,1685,4435,1167,-492,-518,False,False
6695,140,24,4867,1690,4205,1159,-662,-531,False,False
6696,140,25,4502,1644,4071,1129,-431,-515,False,False
6697,140,26,4193,1572,4064,1165,-129,-407,False,False
6698,140,27,3939,1549,4155,1132,216,-417,True,False
6699,140,28,4280,1493,4402,1200,122,-293,True,False
6700,140,29,4789,1506,4484,1248,-305,-258,False,False
6701,140,30,4981,1575,4801,1260,-180,-315,False,False
6702,140,31,5114,1690,4601,1444,-513,-246,False,False
6703,140,32,4531,1584,4102,1449,-429,-135,False,False
6704,140,33,3746,1463,3359,1406,-387,-57,False,False
6705,140,34,3505,1360,3011,1336,-494,-24,False,False
6706,140,35,4339,1519,3195,1430,-1144,-89,False,False
6707,140,36,5518,1631,4230,1531,-1288,-100,False,False
6708,140,37,5779,1656,4848,1686,-931,30,False,True
6709,140,38,5656,1732,5221,1595,-435,-137,False,False
6710,140,39,5421,1679,5221,1622,-200,-57,False,False
6711,140,40,5068,1608,4763,1443,-305,-165,False,False
6712,140,41,4476,1521,4456,1330,-20,-191,False,False
6713,140,42,3746,1364,4008,1397,262,33,True,True
6714,140,43,3694,1208,4259,1314,565,106,True,True
6715,140,44,3220,1157,4397,1429,1177,272,True,True
6716,140,45,3122,1161,4613,1575,1491,414,True,True
6717,140,46,2399,1088,4039,1523,1640,435,True,True
6718,140,47,2304,1067,3758,1524,1454,457,True,True
6719,140,48,1954,812,3111,1455,1157,643,True,True
6720,141,1,2766,2481,3935,2680,1169,199,True,True
6721,141,2,1991,2267,2980,2822,989,555,True,True
6722,141,3,1509,1914,2244,2689,735,775,True,True
6723,141,4,1144,1595,1610,2548,466,953,True,True
6724,141,5,969,1456,1315,2391,346,935,True,True
6725,141,6,827,1180,955,2187,128,1007,True,True
6726,141,7,666,943,730,1742,64,799,True,True
6727,141,8,596,935,525,1372,-71,437,False,True
6728,141,9,732,1092,513,1171,-219,79,False,True
6729,141,10,755,631,354,682,-401,51,False,True
6730,141,11,926,440,382,386,-544,-54,False,False
6731,141,12,1678,379,748,316,-930,-63,False,False
6732,141,13,2808,424,1207,249,-1601,-175,False,False
6733,141,14,5068,664,2331,427,-2737,-237,False,False
6734,141,15,7084,839,2501,522,-4583,-317,False,False
6735,141,16,8902,1070,3136,540,-5766,-530,False,False
6736,141,17,9407,1277,3579,672,-5828,-605,False,False
6737,141,18,8667,1679,3608,919,-5059,-760,False,False
6738,141,19,7194,1961,3577,1097,-3617,-864,False,False
6739,141,20,6557,2410,3613,1450,-2944,-960,False,False
6740,141,21,5762,2474,3773,1739,-1989,-735,False,False
6741,141,22,5557,2840,3968,1792,-1589,-1048,False,False
6742,141,23,5181,2780,4326,1998,-855,-782,False,False
6743,141,24,5284,2908,4639,2071,-645,-837,False,False
6744,141,25,5490,2851,5060,2210,-430,-641,False,False
6745,141,26,5141,2930,4946,2261,-195,-669,False,False
6746,141,27,5061,2857,4868,2256,-193,-601,False,False
6747,141,28,5073,2653,4692,2300,-381,-353,False,False
6748,141,29,5218,2573,5078,2297,-140,-276,False,False
6749,141,30,5465,2595,5341,2284,-124,-311,False,False
6750,141,31,5316,2580,5382,2478,66,-102,True,False
6751,141,32,4918,2547,5150,2449,232,-98,True,False
6752,141,33,4318,2391,4720,2433,402,42,True,True
6753,141,34,4175,2203,4267,2293,92,90,True,True
6754,141,35,5652,2371,5028,2402,-624,31,False,True
6755,141,36,6601,2665,6375,2717,-226,52,False,True
6756,141,37,7497,2778,7621,2957,124,179,True,True
6757,141,38,7875,2916,8534,3114,659,198,True,True
6758,141,39,7783,3119,9083,3116,1300,-3,True,False
6759,141,40,7228,2871,9099,3006,1871,135,True,True
6760,141,41,6875,2802,8839,2824,1964,22,True,True
6761,141,42,6445,2579,8099,2696,1654,117,True,True
6762,141,43,6471,2582,7990,2588,1519,6,True,True
6763,141,44,6049,2469,8086,2686,2037,217,True,True
6764,141,45,6198,2465,8063,2773,1865,308,True,True
6765,141,46,5365,2357,7476,2863,2111,506,True,True
6766,141,47,4830,2249,6542,2843,1712,594,True,True
6767,141,48,4146,1980,5488,2360,1342,380,True,True
6768,142,1,4032,3376,3186,2305,-846,-1071,False,False
6769,142,2,3005,3081,2478,2129,-527,-952,False,False
6770,142,3,2080,2682,1788,1881,-292,-801,False,False
6771,142,4,1341,1827,1207,1656,-134,-171,False,False
6772,142,5,947,1554,986,1515,39,-39,True,False
6773,142,6,754,1214,721,1289,-33,75,False,True
6774,142,7,456,789,562,1084,106,295,True,True
6775,142,8,358,653,421,991,63,338,True,True
6776,142,9,453,463,429,748,-24,285,False,True
6777,142,10,541,328,382,500,-159,172,False,True
6778,142,11,678,297,433,318,-245,21,False,True
6779,142,12,1193,263,806,287,-387,24,False,True
6780,142,13,1966,375,1173,318,-793,-57,False,False
6781,142,14,3727,508,1970,407,-1757,-101,False,False
6782,142,15,4915,594,2512,676,-2403,82,False,True
6783,142,16,6260,834,3316,1074,-2944,240,False,True
6784,142,17,6777,969,3807,1021,-2970,52,False,True
6785,142,18,7281,1453,4403,1655,-2878,202,False,True
6786,142,19,6907,1848,4827,1849,-2080,1,False,True
6787,142,20,6631,2215,5223,2217,-1408,2,False,True
6788,142,21,6054,2352,5222,2363,-832,11,False,True
6789,142,22,6190,2629,5386,2715,-804,86,False,True
6790,142,23,6132,2586,5565,2854,-567,268,False,True
6791,142,24,6303,2856,6032,3190,-271,334,False,True
6792,142,25,6458,3103,6624,3452,166,349,True,True
6793,142,26,6604,3343,6540,3530,-64,187,False,True
6794,142,27,6196,3341,6497,3965,301,624,True,True
6795,142,28,6801,3357,6531,4266,-270,909,False,True
6796,142,29,6923,3342,6129,3561,-794,219,False,True
6797,142,30,7212,3442,6556,3480,-656,38,False,True
6798,142,31,6962,3462,6476,3321,-486,-141,False,False
6799,142,32,6703,3384,6489,3456,-214,72,False,True
6800,142,33,5785,3367,5806,3255,21,-112,True,False
6801,142,34,5256,2927,5205,2915,-51,-12,False,False
6802,142,35,6105,2858,6008,2848,-97,-10,False,False
6803,142,36,8126,3741,8257,3368,131,-373,True,False
6804,142,37,9441,4011,9443,3810,2,-201,True,False
6805,142,38,9945,3940,11737,4189,1792,249,True,True
6806,142,39,9686,3928,13160,4611,3474,683,True,True
6807,142,40,9029,3623,10596,4729,1567,1106,True,True
6808,142,41,8105,3050,8126,2959,21,-91,True,False
6809,142,42,8354,2915,7221,2575,-1133,-340,False,False
6810,142,43,9834,3453,6942,2592,-2892,-861,False,False
6811,142,44,11215,3515,6947,2792,-4268,-723,False,False
6812,142,45,11829,3808,6557,2610,-5272,-1198,False,False
6813,142,46,9593,3595,5931,2423,-3662,-1172,False,False
6814,142,47,7480,3118,5130,2355,-2350,-763,False,False
6815,142,48,5916,2824,4439,2049,-1477,-775,False,False
6816,143,1,859,869,2033,1285,1174,416,True,True
6817,143,2,626,717,1602,1221,976,504,True,True
6818,143,3,446,497,1094,1124,648,627,True,True
6819,143,4,298,406,740,1079,442,673,True,True
6820,143,5,254,325,654,993,400,668,True,True
6821,143,6,198,264,429,889,231,625,True,True
6822,143,7,139,181,393,758,254,577,True,True
6823,143,8,127,161,309,667,182,506,True,True
6824,143,9,212,143,253,545,41,402,True,True
6825,143,10,254,158,216,342,-38,184,False,True
6826,143,11,409,142,207,209,-202,67,False,True
6827,143,12,698,150,241,143,-457,-7,False,False
6828,143,13,1356,224,431,110,-925,-114,False,False
6829,143,14,2637,349,671,155,-1966,-194,False,False
6830,143,15,3561,410,801,195,-2760,-215,False,False
6831,143,16,4016,611,1416,292,-2600,-319,False,False
6832,143,17,3784,703,1790,396,-1994,-307,False,False
6833,143,18,3594,945,1851,525,-1743,-420,False,False
6834,143,19,3607,1102,1732,600,-1875,-502,False,False
6835,143,20,3726,1417,1808,747,-1918,-670,False,False
6836,143,21,3272,1418,1806,876,-1466,-542,False,False
6837,143,22,3059,1569,1936,956,-1123,-613,False,False
6838,143,23,2975,1570,2137,980,-838,-590,False,False
6839,143,24,3085,1599,2108,1044,-977,-555,False,False
6840,143,25,3134,1575,2332,1088,-802,-487,False,False
6841,143,26,2910,1629,2302,1133,-608,-496,False,False
6842,143,27,2767,1585,2313,1172,-454,-413,False,False
6843,143,28,2655,1533,2274,1192,-381,-341,False,False
6844,143,29,2521,1346,2342,1254,-179,-92,False,False
6845,143,30,2803,1329,2605,1250,-198,-79,False,False
6846,143,31,2594,1208,2733,1256,139,48,True,True
6847,143,32,2429,1189,2733,1222,304,33,True,True
6848,143,33,2160,1261,2534,1191,374,-70,True,False
6849,143,34,2054,1052,2333,1107,279,55,True,True
6850,143,35,2258,1080,2475,1068,217,-12,True,False
6851,143,36,2975,1367,3179,1217,204,-150,True,False
6852,143,37,3470,1475,3660,1383,190,-92,True,False
6853,143,38,3619,1485,3842,1355,223,-130,True,False
6854,143,39,3691,1512,4273,1382,582,-130,True,False
6855,143,40,3359,1508,4467,1257,1108,-251,True,False
6856,143,41,2872,1296,4357,1206,1485,-90,True,False
6857,143,42,2532,1179,3967,1133,1435,-46,True,False
6858,143,43,2469,1138,4029,1199,1560,61,True,True
6859,143,44,2193,1084,4032,1197,1839,113,True,True
6860,143,45,2259,982,3969,1291,1710,309,True,True
6861,143,46,1845,946,3627,1307,1782,361,True,True
6862,143,47,1575,936,3357,1294,1782,358,True,True
6863,143,48,1250,795,2659,1172,1409,377,True,True
6864,144,1,3638,3063,2330,2262,-1308,-801,False,False
6865,144,2,3047,2957,2074,2272,-973,-685,False,False
6866,144,3,2459,3260,1621,2279,-838,-981,False,False
6867,144,4,1995,3276,1231,1989,-764,-1287,False,False
6868,144,5,1719,3224,1045,1747,-674,-1477,False,False
6869,144,6,1347,2990,752,1504,-595,-1486,False,False
6870,144,7,1012,2516,570,1229,-442,-1287,False,False
6871,144,8,728,2140,414,1039,-314,-1101,False,False
6872,144,9,559,1533,393,749,-166,-784,False,False
6873,144,10,396,916,275,461,-121,-455,False,False
6874,144,11,344,478,202,277,-142,-201,False,False
6875,144,12,462,301,215,159,-247,-142,False,False
6876,144,13,638,223,277,124,-361,-99,False,False
6877,144,14,936,215,490,152,-446,-63,False,False
6878,144,15,1125,226,556,167,-569,-59,False,False
6879,144,16,1416,312,805,195,-611,-117,False,False
6880,144,17,1532,328,1062,232,-470,-96,False,False
6881,144,18,1916,437,1404,372,-512,-65,False,False
6882,144,19,1885,492,1822,499,-63,7,False,True
6883,144,20,1887,628,1980,719,93,91,True,True
6884,144,21,1755,749,2195,932,440,183,True,True
6885,144,22,1932,893,2273,1142,341,249,True,True
6886,144,23,1785,964,2404,1394,619,430,True,True
6887,144,24,1979,1207,2296,1488,317,281,True,True
6888,144,25,2005,1290,2290,1529,285,239,True,True
6889,144,26,1981,1330,2219,1546,238,216,True,True
6890,144,27,1941,1416,2094,1585,153,169,True,True
6891,144,28,2109,1526,2090,1437,-19,-89,False,False
6892,144,29,2362,1579,2200,1498,-162,-81,False,False
6893,144,30,2307,1477,2189,1431,-118,-46,False,False
6894,144,31,2120,1498,2164,1441,44,-57,True,False
6895,144,32,1923,1373,1982,1363,59,-10,True,False
6896,144,33,1627,1185,1733,1227,106,42,True,True
6897,144,34,1546,1138,1602,1150,56,12,True,True
6898,144,35,1968,1329,1638,1220,-330,-109,False,False
6899,144,36,2515,1636,2284,1521,-231,-115,False,False
6900,144,37,3091,1883,2875,1795,-216,-88,False,False
6901,144,38,3484,1954,3544,1901,60,-53,True,False
6902,144,39,4090,2035,4066,2056,-24,21,False,True
6903,144,40,4461,2055,4640,1930,179,-125,True,False
6904,144,41,4679,1953,4543,2141,-136,188,False,True
6905,144,42,4579,2008,4106,1853,-473,-155,False,False
6906,144,43,4800,2061,3929,1910,-871,-151,False,False
6907,144,44,5140,1994,3533,1680,-1607,-314,False,False
6908,144,45,5149,2041,3335,1643,-1814,-398,False,False
6909,144,46,5293,2104,3368,1595,-1925,-509,False,False
6910,144,47,5334,2048,3278,1692,-2056,-356,False,False
6911,144,48,4918,1936,3217,1661,-1701,-275,False,False
6912,145,1,401,349,959,575,558,226,True,True
6913,145,2,376,381,855,596,479,215,True,True
6914,145,3,403,353,703,588,300,235,True,True
6915,145,4,280,342,583,584,303,242,True,True
6916,145,5,235,297,447,523,212,226,True,True
6917,145,6,163,239,350,515,187,276,True,True
6918,145,7,123,176,285,429,162,253,True,True
6919,145,8,121,194,228,434,107,240,True,True
6920,145,9,138,177,241,411,103,234,True,True
6921,145,10,85,129,204,292,119,163,True,True
6922,145,11,83,113,188,232,105,119,True,True
6923,145,12,127,125,190,166,63,41,True,True
6924,145,13,136,99,214,132,78,33,True,True
6925,145,14,255,109,362,114,107,5,True,True
6926,145,15,217,129,346,110,129,-19,True,False
6927,145,16,271,126,467,103,196,-23,True,False
6928,145,17,241,156,530,128,289,-28,True,False
6929,145,18,249,121,526,143,277,22,True,True
6930,145,19,238,143,471,165,233,22,True,True
6931,145,20,253,131,504,168,251,37,True,True
6932,145,21,239,128,438,200,199,72,True,True
6933,145,22,260,143,445,214,185,71,True,True
6934,145,23,313,158,470,196,157,38,True,True
6935,145,24,295,146,434,203,139,57,True,True
6936,145,25,286,155,390,204,104,49,True,True
6937,145,26,255,175,397,227,142,52,True,True
6938,145,27,266,150,419,191,153,41,True,True
6939,145,28,230,136,374,205,144,69,True,True
6940,145,29,287,158,390,234,103,76,True,True
6941,145,30,284,170,419,245,135,75,True,True
6942,145,31,276,187,410,255,134,68,True,True
6943,145,32,276,180,368,290,92,110,True,True
6944,145,33,284,200,358,240,74,40,True,True
6945,145,34,314,195,373,278,59,83,True,True
6946,145,35,405,208,399,312,-6,104,False,True
6947,145,36,434,250,428,319,-6,69,False,True
6948,145,37,411,195,487,314,76,119,True,True
6949,145,38,360,185,569,315,209,130,True,True
6950,145,39,449,225,735,310,286,85,True,True
6951,145,40,374,208,713,277,339,69,True,True
6952,145,41,314,201,791,337,477,136,True,True
6953,145,42,358,197,800,297,442,100,True,True
6954,145,43,395,212,890,292,495,80,True,True
6955,145,44,416,213,1048,334,632,121,True,True
6956,145,45,400,215,1077,353,677,138,True,True
6957,145,46,438,251,1141,387,703,136,True,True
6958,145,47,426,277,1133,439,707,162,True,True
6959,145,48,452,288,1152,469,700,181,True,True
6960,146,1,313,158,394,211,81,53,True,True
6961,146,2,277,158,429,245,152,87,True,True
6962,146,3,249,181,336,260,87,79,True,True
6963,146,4,151,191,279,270,128,79,True,True
6964,146,5,135,140,229,282,94,142,True,True
6965,146,6,119,153,200,278,81,125,True,True
6966,146,7,110,141,157,184,47,43,True,True
6967,146,8,126,136,128,210,2,74,True,True
6968,146,9,147,179,154,201,7,22,True,True
6969,146,10,160,152,143,184,-17,32,False,True
6970,146,11,162,122,113,124,-49,2,False,True
6971,146,12,139,98,93,86,-46,-12,False,False
6972,146,13,136,99,97,79,-39,-20,False,False
6973,146,14,192,102,141,68,-51,-34,False,False
6974,146,15,162,99,132,61,-30,-38,False,False
6975,146,16,192,97,198,48,6,-49,True,False
6976,146,17,214,109,192,62,-22,-47,False,False
6977,146,18,225,139,218,61,-7,-78,False,False
6978,146,19,205,117,206,74,1,-43,True,False
6979,146,20,187,128,165,79,-22,-49,False,False
6980,146,21,228,135,197,71,-31,-64,False,False
6981,146,22,277,143,188,77,-89,-66,False,False
6982,146,23,245,127,213,68,-32,-59,False,False
6983,146,24,285,111,222,71,-63,-40,False,False
6984,146,25,233,119,192,73,-41,-46,False,False
6985,146,26,212,140,219,89,7,-51,True,False
6986,146,27,204,102,190,66,-14,-36,False,False
6987,146,28,237,103,205,75,-32,-28,False,False
6988,146,29,227,105,206,66,-21,-39,False,False
6989,146,30,250,101,210,102,-40,1,False,True
6990,146,31,185,92,206,97,21,5,True,True
6991,146,32,176,102,184,100,8,-2,True,False
6992,146,33,202,87,196,92,-6,5,False,True
6993,146,34,225,108,165,91,-60,-17,False,False
6994,146,35,369,121,191,97,-178,-24,False,False
6995,146,36,426,144,248,120,-178,-24,False,False
6996,146,37,375,103,247,90,-128,-13,False,False
6997,146,38,328,111,236,117,-92,6,False,True
6998,146,39,311,132,190,109,-121,-23,False,False
6999,146,40,271,111,261,95,-10,-16,False,False
7000,146,41,192,113,243,92,51,-21,True,False
7001,146,42,175,117,301,124,126,7,True,True
7002,146,43,175,111,294,116,119,5,True,True
7003,146,44,198,144,343,135,145,-9,True,False
7004,146,45,251,104,369,153,118,49,True,True
7005,146,46,291,108,405,160,114,52,True,True
7006,146,47,262,127,436,169,174,42,True,True
7007,146,48,273,142,443,173,170,31,True,True
7008,147,1,1,0,25,24,24,24,True,True
7009,147,2,0,0,22,27,22,27,True,True
7010,147,3,0,0,16,20,16,20,True,True
7011,147,4,0,2,15,15,15,13,True,True
7012,147,5,2,2,26,26,24,24,True,True
7013,147,6,1,2,14,21,13,19,True,True
7014,147,7,0,0,4,23,4,23,True,True
7015,147,8,1,1,15,18,14,17,True,True
7016,147,9,0,1,7,28,7,27,True,True
7017,147,10,0,3,7,17,7,14,True,True
7018,147,11,1,0,6,14,5,14,True,True
7019,147,12,0,0,4,8,4,8,True,True
7020,147,13,2,1,2,8,0,7,False,True
7021,147,14,0,1,10,6,10,5,True,True
7022,147,15,0,4,3,10,3,6,True,True
7023,147,16,2,0,4,3,2,3,True,True
7024,147,17,0,0,11,2,11,2,True,True
7025,147,18,0,1,10,0,10,-1,True,False
7026,147,19,1,0,2,3,1,3,True,True
7027,147,20,0,0,2,4,2,4,True,True
7028,147,21,0,1,2,2,2,1,True,True
7029,147,22,1,0,12,1,11,1,True,True
7030,147,23,0,0,2,4,2,4,True,True
7031,147,24,0,1,4,3,4,2,True,True
7032,147,25,0,0,5,4,5,4,True,True
7033,147,26,0,0,4,2,4,2,True,True
7034,147,27,0,0,4,2,4,2,True,True
7035,147,28,0,0,3,1,3,1,True,True
7036,147,29,0,1,3,2,3,1,True,True
7037,147,30,0,1,5,6,5,5,True,True
7038,147,31,0,1,4,3,4,2,True,True
7039,147,32,0,0,6,4,6,4,True,True
7040,147,33,0,1,3,1,3,0,True,False
7041,147,34,0,0,5,3,5,3,True,True
7042,147,35,0,0,2,3,2,3,True,True
7043,147,36,0,2,4,7,4,5,True,True
7044,147,37,0,1,5,3,5,2,True,True
7045,147,38,0,2,7,3,7,1,True,True
7046,147,39,0,1,9,6,9,5,True,True
7047,147,40,0,1,13,7,13,6,True,True
7048,147,41,0,2,4,5,4,3,True,True
7049,147,42,0,0,7,4,7,4,True,True
7050,147,43,0,0,12,6,12,6,True,True
7051,147,44,1,0,15,12,14,12,True,True
7052,147,45,0,0,19,14,19,14,True,True
7053,147,46,0,2,18,8,18,6,True,True
7054,147,47,0,1,30,12,30,11,True,True
7055,147,48,1,1,27,12,26,11,True,True
7056,148,1,5890,5802,3465,4955,-2425,-847,False,False
7057,148,2,5116,6413,3121,5127,-1995,-1286,False,False
7058,148,3,4219,6943,2420,4628,-1799,-2315,False,False
7059,148,4,3660,7315,1863,3781,-1797,-3534,False,False
7060,148,5,3065,7205,1456,2881,-1609,-4324,False,False
7061,148,6,2672,7137,1091,2249,-1581,-4888,False,False
7062,148,7,2253,6736,877,1763,-1376,-4973,False,False
7063,148,8,1885,5861,634,1321,-1251,-4540,False,False
7064,148,9,1668,4555,527,1155,-1141,-3400,False,False
7065,148,10,1009,2529,386,833,-623,-1696,False,False
7066,148,11,726,1352,230,457,-496,-895,False,False
7067,148,12,796,803,201,289,-595,-514,False,False
7068,148,13,828,556,262,185,-566,-371,False,False
7069,148,14,1168,476,312,199,-856,-277,False,False
7070,148,15,1252,447,397,214,-855,-233,False,False
7071,148,16,1328,421,531,266,-797,-155,False,False
7072,148,17,1373,462,533,251,-840,-211,False,False
7073,148,18,1347,596,543,300,-804,-296,False,False
7074,148,19,1520,614,710,390,-810,-224,False,False
7075,148,20,1640,792,814,592,-826,-200,False,False
7076,148,21,1440,816,980,651,-460,-165,False,False
7077,148,22,1398,910,1069,810,-329,-100,False,False
7078,148,23,1191,994,1209,1061,18,67,True,True
7079,148,24,1272,1071,1256,1239,-16,168,False,True
7080,148,25,1191,1069,1298,1439,107,370,True,True
7081,148,26,1226,1141,1289,1427,63,286,True,True
7082,148,27,1296,1178,1279,1367,-17,189,False,True
7083,148,28,1349,1216,1218,1340,-131,124,False,True
7084,148,29,1329,1269,1317,1288,-12,19,False,True
7085,148,30,1431,1321,1337,1230,-94,-91,False,False
7086,148,31,1304,1288,1231,1177,-73,-111,False,False
7087,148,32,1197,1253,1162,1072,-35,-181,False,False
7088,148,33,1075,1118,1115,1007,40,-111,True,False
7089,148,34,1117,1122,1159,1012,42,-110,True,False
7090,148,35,1375,1275,1243,1095,-132,-180,False,False
7091,148,36,1683,1327,1796,1345,113,18,True,True
7092,148,37,2008,1404,2556,1450,548,46,True,True
7093,148,38,2350,1402,3554,1792,1204,390,True,True
7094,148,39,2579,1547,4244,2119,1665,572,True,True
7095,148,40,3176,1643,5064,2202,1888,559,True,True
7096,148,41,3460,1743,5240,2311,1780,568,True,True
7097,148,42,4294,1751,5280,2424,986,673,True,True
7098,148,43,5053,1891,5350,2562,297,671,True,True
7099,148,44,5351,2168,4843,2496,-508,328,False,True
7100,148,45,5937,2388,4659,2559,-1278,171,False,True
7101,148,46,6251,2638,4552,2802,-1699,164,False,True
7102,148,47,7099,3108,4827,3089,-2272,-19,False,False
7103,148,48,7339,3256,4955,3350,-2384,94,False,True
7104,149,1,2,1,48,17,46,16,True,True
7105,149,2,3,1,57,19,54,18,True,True
7106,149,3,0,1,53,25,53,24,True,True
7107,149,4,2,2,41,26,39,24,True,True
7108,149,5,2,2,33,25,31,23,True,True
7109,149,6,0,0,18,23,18,23,True,True
7110,149,7,1,5,17,43,16,38,True,True
7111,149,8,1,5,13,34,12,29,True,True
7112,149,9,0,5,12,38,12,33,True,True
7113,149,10,0,1,18,30,18,29,True,True
7114,149,11,0,0,16,30,16,30,True,True
7115,149,12,0,0,15,17,15,17,True,True
7116,149,13,0,0,12,9,12,9,True,True
7117,149,14,0,0,10,10,10,10,True,True
7118,149,15,1,0,9,5,8,5,True,True
7119,149,16,5,1,10,6,5,5,True,True
7120,149,17,3,0,14,2,11,2,True,True
7121,149,18,2,0,8,3,6,3,True,True
7122,149,19,1,0,10,4,9,4,True,True
7123,149,20,0,0,6,8,6,8,True,True
7124,149,21,2,0,7,7,5,7,True,True
7125,149,22,0,3,8,6,8,3,True,True
7126,149,23,0,1,4,6,4,5,True,True
7127,149,24,1,0,7,7,6,7,True,True
7128,149,25,0,0,3,6,3,6,True,True
7129,149,26,2,0,8,1,6,1,True,True
7130,149,27,1,0,6,7,5,7,True,True
7131,149,28,1,0,10,10,9,10,True,True
7132,149,29,0,0,16,3,16,3,True,True
7133,149,30,1,2,18,12,17,10,True,True
7134,149,31,0,0,16,9,16,9,True,True
7135,149,32,1,1,14,6,13,5,True,True
7136,149,33,1,0,16,5,15,5,True,True
7137,149,34,1,0,11,3,10,3,True,True
7138,149,35,0,0,7,2,7,2,True,True
7139,149,36,1,1,20,9,19,8,True,True
7140,149,37,0,0,21,6,21,6,True,True
7141,149,38,0,1,14,5,14,4,True,True
7142,149,39,0,2,24,9,24,7,True,True
7143,149,40,0,0,20,8,20,8,True,True
7144,149,41,0,0,24,6,24,6,True,True
7145,149,42,0,0,26,5,26,5,True,True
7146,149,43,1,0,25,8,24,8,True,True
7147,149,44,1,0,51,16,50,16,True,True
7148,149,45,2,0,41,8,39,8,True,True
7149,149,46,2,1,45,10,43,9,True,True
7150,149,47,2,0,44,19,42,19,True,True
7151,149,48,1,2,48,18,47,16,True,True
7152,150,1,1,1,14,10,13,9,True,True
7153,150,2,0,2,11,9,11,7,True,True
7154,150,3,0,1,16,15,16,14,True,True
7155,150,4,0,1,11,19,11,18,True,True
7156,150,5,0,2,9,12,9,10,True,True
7157,150,6,0,2,5,13,5,11,True,True
7158,150,7,0,3,4,11,4,8,True,True
7159,150,8,0,1,5,15,5,14,True,True
7160,150,9,2,0,13,17,11,17,True,True
7161,150,10,0,2,6,10,6,8,True,True
7162,150,11,2,0,7,9,5,9,True,True
7163,150,12,1,0,6,10,5,10,True,True
7164,150,13,1,0,5,4,4,4,True,True
7165,150,14,0,0,3,4,3,4,True,True
7166,150,15,1,0,4,3,3,3,True,True
7167,150,16,0,0,6,3,6,3,True,True
7168,150,17,0,0,4,4,4,4,True,True
7169,150,18,0,0,3,4,3,4,True,True
7170,150,19,0,0,7,2,7,2,True,True
7171,150,20,0,0,7,5,7,5,True,True
7172,150,21,0,0,5,5,5,5,True,True
7173,150,22,0,0,2,1,2,1,True,True
7174,150,23,0,0,1,5,1,5,True,True
7175,150,24,2,1,6,4,4,3,True,True
7176,150,25,0,0,4,4,4,4,True,True
7177,150,26,0,0,6,4,6,4,True,True
7178,150,27,1,0,4,5,3,5,True,True
7179,150,28,0,1,7,3,7,2,True,True
7180,150,29,0,2,11,6,11,4,True,True
7181,150,30,1,0,6,5,5,5,True,True
7182,150,31,0,0,6,7,6,7,True,True
7183,150,32,0,0,5,7,5,7,True,True
7184,150,33,1,0,10,5,9,5,True,True
7185,150,34,0,1,7,8,7,7,True,True
7186,150,35,0,1,8,2,8,1,True,True
7187,150,36,0,1,7,6,7,5,True,True
7188,150,37,0,1,10,6,10,5,True,True
7189,150,38,1,0,11,8,10,8,True,True
7190,150,39,0,0,8,5,8,5,True,True
7191,150,40,1,1,10,10,9,9,True,True
7192,150,41,1,1,18,7,17,6,True,True
7193,150,42,0,0,14,9,14,9,True,True
7194,150,43,0,1,9,5,9,4,True,True
7195,150,44,2,0,15,6,13,6,True,True
7196,150,45,1,0,30,3,29,3,True,True
7197,150,46,2,2,24,6,22,4,True,True
7198,150,47,0,0,22,4,22,4,True,True
7199,150,48,1,0,27,7,26,7,True,True
7200,151,1,664,642,1617,977,953,335,True,True
7201,151,2,521,535,1318,981,797,446,True,True
7202,151,3,432,438,1013,1003,581,565,True,True
7203,151,4,310,337,735,949,425,612,True,True
7204,151,5,252,348,601,848,349,500,True,True
7205,151,6,206,256,470,782,264,526,True,True
7206,151,7,164,247,382,699,218,452,True,True
7207,151,8,171,205,297,553,126,348,True,True
7208,151,9,218,191,268,476,50,285,True,True
7209,151,10,273,161,199,361,-74,200,False,True
7210,151,11,369,152,131,200,-238,48,False,True
7211,151,12,554,170,172,167,-382,-3,False,False
7212,151,13,888,191,160,128,-728,-63,False,False
7213,151,14,1704,307,205,118,-1499,-189,False,False
7214,151,15,1959,364,375,133,-1584,-231,False,False
7215,151,16,2363,507,555,266,-1808,-241,False,False
7216,151,17,2544,533,728,260,-1816,-273,False,False
7217,151,18,2153,813,813,324,-1340,-489,False,False
7218,151,19,2017,860,781,405,-1236,-455,False,False
7219,151,20,1835,1010,730,581,-1105,-429,False,False
7220,151,21,1862,1081,841,632,-1021,-449,False,False
7221,151,22,1888,1148,860,712,-1028,-436,False,False
7222,151,23,1775,1148,982,712,-793,-436,False,False
7223,151,24,1761,1137,1095,666,-666,-471,False,False
7224,151,25,1866,1123,1178,774,-688,-349,False,False
7225,151,26,1775,1195,1289,837,-486,-358,False,False
7226,151,27,1664,1130,1202,838,-462,-292,False,False
7227,151,28,1733,1028,1408,792,-325,-236,False,False
7228,151,29,1677,1129,1478,796,-199,-333,False,False
7229,151,30,1782,1004,1598,800,-184,-204,False,False
7230,151,31,1804,1065,1896,833,92,-232,True,False
7231,151,32,1741,982,1927,901,186,-81,True,False
7232,151,33,1514,965,1805,805,291,-160,True,False
7233,151,34,1570,871,1637,771,67,-100,True,False
7234,151,35,1846,991,1865,786,19,-205,True,False
7235,151,36,2268,1038,2220,820,-48,-218,False,False
7236,151,37,2183,1073,2522,944,339,-129,True,False
7237,151,38,2485,1088,2868,902,383,-186,True,False
7238,151,39,2372,1034,2725,888,353,-146,True,False
7239,151,40,2011,911,2640,821,629,-90,True,False
7240,151,41,1847,823,2679,770,832,-53,True,False
7241,151,42,1628,735,2585,775,957,40,True,True
7242,151,43,1672,743,2764,852,1092,109,True,True
7243,151,44,1417,751,2769,963,1352,212,True,True
7244,151,45,1307,641,2764,932,1457,291,True,True
7245,151,46,1203,638,2572,954,1369,316,True,True
7246,151,47,1019,650,2278,948,1259,298,True,True
7247,151,48,893,567,2012,954,1119,387,True,True
7248,152,1,172,154,497,276,325,122,True,True
7249,152,2,165,160,424,294,259,134,True,True
7250,152,3,131,118,411,335,280,217,True,True
7251,152,4,98,115,338,321,240,206,True,True
7252,152,5,83,117,317,337,234,220,True,True
7253,152,6,64,104,234,320,170,216,True,True
7254,152,7,64,92,199,331,135,239,True,True
7255,152,8,44,94,167,271,123,177,True,True
7256,152,9,48,103,168,281,120,178,True,True
7257,152,10,69,77,141,235,72,158,True,True
7258,152,11,53,62,83,151,30,89,True,True
7259,152,12,72,56,110,101,38,45,True,True
7260,152,13,87,58,133,72,46,14,True,True
7261,152,14,155,75,166,61,11,-14,True,False
7262,152,15,176,56,301,63,125,7,True,True
7263,152,16,237,51,359,65,122,14,True,True
7264,152,17,183,67,345,105,162,38,True,True
7265,152,18,205,58,249,75,44,17,True,True
7266,152,19,187,90,213,81,26,-9,True,False
7267,152,20,177,97,213,80,36,-17,True,False
7268,152,21,152,98,192,105,40,7,True,True
7269,152,22,177,115,166,106,-11,-9,False,False
7270,152,23,137,101,193,101,56,0,True,False
7271,152,24,150,102,213,142,63,40,True,True
7272,152,25,146,107,229,135,83,28,True,True
7273,152,26,157,109,204,127,47,18,True,True
7274,152,27,139,100,205,135,66,35,True,True
7275,152,28,161,94,199,132,38,38,True,True
7276,152,29,143,99,224,123,81,24,True,True
7277,152,30,173,94,185,135,12,41,True,True
7278,152,31,164,120,214,140,50,20,True,True
7279,152,32,153,100,220,139,67,39,True,True
7280,152,33,151,92,196,124,45,32,True,True
7281,152,34,164,87,197,119,33,32,True,True
7282,152,35,228,106,198,119,-30,13,False,True
7283,152,36,283,99,300,143,17,44,True,True
7284,152,37,265,101,351,164,86,63,True,True
7285,152,38,265,116,357,143,92,27,True,True
7286,152,39,277,109,390,164,113,55,True,True
7287,152,40,262,107,390,151,128,44,True,True
7288,152,41,237,107,386,145,149,38,True,True
7289,152,42,207,116,340,148,133,32,True,True
7290,152,43,319,117,387,153,68,36,True,True
7291,152,44,275,138,461,200,186,62,True,True
7292,152,45,320,152,399,159,79,7,True,True
7293,152,46,266,142,423,215,157,73,True,True
7294,152,47,277,141,459,224,182,83,True,True
7295,152,48,234,144,454,260,220,116,True,True
7296,153,1,2,1,8,5,6,4,True,True
7297,153,2,0,3,16,11,16,8,True,True
7298,153,3,0,0,11,13,11,13,True,True
7299,153,4,3,0,14,6,11,6,True,True
7300,153,5,0,1,18,13,18,12,True,True
7301,153,6,1,2,11,14,10,12,True,True
7302,153,7,1,1,4,19,3,18,True,True
7303,153,8,0,1,2,11,2,10,True,True
7304,153,9,0,1,2,17,2,16,True,True
7305,153,10,0,0,8,7,8,7,True,True
7306,153,11,1,1,3,6,2,5,True,True
7307,153,12,0,0,3,3,3,3,True,True
7308,153,13,1,0,1,4,0,4,False,True
7309,153,14,1,0,1,2,0,2,False,True
7310,153,15,0,0,2,5,2,5,True,True
7311,153,16,1,0,3,2,2,2,True,True
7312,153,17,4,0,6,0,2,0,True,False
7313,153,18,2,1,6,1,4,0,True,False
7314,153,19,0,0,1,1,1,1,True,True
7315,153,20,1,2,3,0,2,-2,True,False
7316,153,21,0,0,4,3,4,3,True,True
7317,153,22,0,0,4,4,4,4,True,True
7318,153,23,0,1,4,1,4,0,True,False
7319,153,24,2,0,3,7,1,7,True,True
7320,153,25,1,0,2,4,1,4,True,True
7321,153,26,2,2,3,2,1,0,True,False
7322,153,27,1,0,3,0,2,0,True,False
7323,153,28,1,0,3,3,2,3,True,True
7324,153,29,0,1,7,4,7,3,True,True
7325,153,30,4,1,2,2,-2,1,False,True
7326,153,31,0,1,2,4,2,3,True,True
7327,153,32,1,1,1,2,0,1,False,True
7328,153,33,1,2,1,4,0,2,False,True
7329,153,34,2,1,2,4,0,3,False,True
7330,153,35,0,1,3,2,3,1,True,True
7331,153,36,0,3,5,2,5,-1,True,False
7332,153,37,0,2,6,2,6,0,True,False
7333,153,38,1,0,3,2,2,2,True,True
7334,153,39,2,2,6,2,4,0,True,False
7335,153,40,0,0,9,3,9,3,True,True
7336,153,41,4,0,8,5,4,5,True,True
7337,153,42,6,1,5,5,-1,4,False,True
7338,153,43,1,1,8,2,7,1,True,True
7339,153,44,3,1,16,3,13,2,True,True
7340,153,45,0,2,18,2,18,0,True,False
7341,153,46,2,1,24,6,22,5,True,True
7342,153,47,0,2,19,10,19,8,True,True
7343,153,48,5,0,20,12,15,12,True,True
7344,154,1,1,0,3,0,2,0,True,False
7345,154,2,0,0,3,3,3,3,True,True
7346,154,3,0,0,1,1,1,1,True,True
7347,154,4,0,0,1,0,1,0,True,False
7348,154,5,2,0,2,2,0,2,False,True
7349,154,6,0,0,1,1,1,1,True,True
7350,154,7,0,0,0,0,0,0,False,False
7351,154,8,0,0,0,2,0,2,False,True
7352,154,9,1,0,0,0,-1,0,False,False
7353,154,10,0,0,0,0,0,0,False,False
7354,154,11,0,0,0,0,0,0,False,False
7355,154,12,0,0,3,2,3,2,True,True
7356,154,13,0,0,1,2,1,2,True,True
7357,154,14,0,0,1,1,1,1,True,True
7358,154,15,0,0,0,0,0,0,False,False
7359,154,16,0,0,1,2,1,2,True,True
7360,154,17,0,0,1,1,1,1,True,True
7361,154,18,1,0,2,2,1,2,True,True
7362,154,19,1,0,1,0,0,0,False,False
7363,154,20,0,0,0,1,0,1,False,True
7364,154,21,1,0,2,2,1,2,True,True
7365,154,22,0,0,1,2,1,2,True,True
7366,154,23,2,2,0,1,-2,-1,False,False
7367,154,24,0,0,0,1,0,1,False,True
7368,154,25,0,0,0,5,0,5,False,True
7369,154,26,1,0,0,1,-1,1,False,True
7370,154,27,0,0,4,1,4,1,True,True
7371,154,28,0,0,2,1,2,1,True,True
7372,154,29,1,0,2,1,1,1,True,True
7373,154,30,1,0,2,2,1,2,True,True
7374,154,31,0,0,0,4,0,4,False,True
7375,154,32,0,0,2,0,2,0,True,False
7376,154,33,0,1,3,2,3,1,True,True
7377,154,34,1,2,3,1,2,-1,True,False
7378,154,35,0,0,1,1,1,1,True,True
7379,154,36,2,0,4,0,2,0,True,False
7380,154,37,0,1,2,0,2,-1,True,False
7381,154,38,0,1,0,1,0,0,False,False
7382,154,39,1,0,2,0,1,0,True,False
7383,154,40,0,0,0,2,0,2,False,True
7384,154,41,0,0,2,0,2,0,True,False
7385,154,42,0,0,3,1,3,1,True,True
7386,154,43,1,0,2,0,1,0,True,False
7387,154,44,1,0,5,2,4,2,True,True
7388,154,45,2,0,2,1,0,1,False,True
7389,154,46,2,0,5,1,3,1,True,True
7390,154,47,2,0,5,2,3,2,True,True
7391,154,48,1,0,2,2,1,2,True,True
7392,155,1,2,1,46,8,44,7,True,True
7393,155,2,1,0,35,20,34,20,True,True
7394,155,3,1,0,33,16,32,16,True,True
7395,155,4,2,1,34,35,32,34,True,True
7396,155,5,1,0,31,24,30,24,True,True
7397,155,6,1,1,15,26,14,25,True,True
7398,155,7,1,0,13,32,12,32,True,True
7399,155,8,0,0,9,24,9,24,True,True
7400,155,9,0,1,14,33,14,32,True,True
7401,155,10,3,1,8,22,5,21,True,True
7402,155,11,1,0,7,15,6,15,True,True
7403,155,12,0,0,8,6,8,6,True,True
7404,155,13,0,0,9,6,9,6,True,True
7405,155,14,0,0,8,10,8,10,True,True
7406,155,15,1,0,11,7,10,7,True,True
7407,155,16,2,0,10,3,8,3,True,True
7408,155,17,1,0,15,3,14,3,True,True
7409,155,18,1,0,11,5,10,5,True,True
7410,155,19,0,0,8,4,8,4,True,True
7411,155,20,0,0,6,7,6,7,True,True
7412,155,21,1,0,7,5,6,5,True,True
7413,155,22,1,0,5,11,4,11,True,True
7414,155,23,0,1,7,5,7,4,True,True
7415,155,24,1,0,7,7,6,7,True,True
7416,155,25,0,0,4,1,4,1,True,True
7417,155,26,0,1,7,7,7,6,True,True
7418,155,27,0,0,12,7,12,7,True,True
7419,155,28,0,0,8,2,8,2,True,True
7420,155,29,1,0,18,8,17,8,True,True
7421,155,30,0,0,14,6,14,6,True,True
7422,155,31,0,0,16,6,16,6,True,True
7423,155,32,0,0,14,10,14,10,True,True
7424,155,33,0,1,8,9,8,8,True,True
7425,155,34,2,0,14,11,12,11,True,True
7426,155,35,0,0,14,3,14,3,True,True
7427,155,36,1,0,4,6,3,6,True,True
7428,155,37,0,0,17,13,17,13,True,True
7429,155,38,0,1,19,10,19,9,True,True
7430,155,39,1,0,20,10,19,10,True,True
7431,155,40,0,0,30,11,30,11,True,True
7432,155,41,1,2,21,9,20,7,True,True
7433,155,42,2,1,23,9,21,8,True,True
7434,155,43,0,1,25,13,25,12,True,True
7435,155,44,1,0,28,5,27,5,True,True
7436,155,45,4,0,47,11,43,11,True,True
7437,155,46,1,0,53,14,52,14,True,True
7438,155,47,2,0,43,20,41,20,True,True
7439,155,48,1,1,49,8,48,7,True,True
7440,156,1,0,0,2,0,2,0,True,False
7441,156,2,0,0,2,3,2,3,True,True
7442,156,3,0,0,5,1,5,1,True,True
7443,156,4,0,0,3,3,3,3,True,True
7444,156,5,0,0,3,5,3,5,True,True
7445,156,6,0,0,5,1,5,1,True,True
7446,156,7,1,0,0,1,-1,1,False,True
7447,156,8,0,0,0,0,0,0,False,False
7448,156,9,0,0,0,1,0,1,False,True
7449,156,10,0,1,2,1,2,0,True,False
7450,156,11,0,0,1,0,1,0,True,False
7451,156,12,0,0,0,0,0,0,False,False
7452,156,13,0,0,0,0,0,0,False,False
7453,156,14,0,0,1,1,1,1,True,True
7454,156,15,0,0,1,0,1,0,True,False
7455,156,16,0,0,0,0,0,0,False,False
7456,156,17,0,1,0,3,0,2,False,True
7457,156,18,0,0,0,1,0,1,False,True
7458,156,19,0,0,0,1,0,1,False,True
7459,156,20,0,0,2,0,2,0,True,False
7460,156,21,0,1,0,2,0,1,False,True
7461,156,22,0,0,1,0,1,0,True,False
7462,156,23,0,0,0,0,0,0,False,False
7463,156,24,0,0,0,0,0,0,False,False
7464,156,25,0,0,0,0,0,0,False,False
7465,156,26,0,0,2,1,2,1,True,True
7466,156,27,0,0,0,0,0,0,False,False
7467,156,28,0,1,0,0,0,-1,False,False
7468,156,29,0,0,0,0,0,0,False,False
7469,156,30,0,0,3,0,3,0,True,False
7470,156,31,0,0,0,2,0,2,False,True
7471,156,32,0,0,1,0,1,0,True,False
7472,156,33,0,0,0,1,0,1,False,True
7473,156,34,0,0,0,0,0,0,False,False
7474,156,35,1,0,1,1,0,1,False,True
7475,156,36,2,0,3,1,1,1,True,True
7476,156,37,2,0,4,0,2,0,True,False
7477,156,38,3,0,4,2,1,2,True,True
7478,156,39,1,0,4,1,3,1,True,True
7479,156,40,1,0,2,0,1,0,True,False
7480,156,41,0,0,0,1,0,1,False,True
7481,156,42,1,0,1,2,0,2,False,True
7482,156,43,1,0,3,2,2,2,True,True
7483,156,44,2,0,8,1,6,1,True,True
7484,156,45,4,0,6,1,2,1,True,True
7485,156,46,0,0,1,1,1,1,True,True
7486,156,47,0,0,5,1,5,1,True,True
7487,156,48,0,0,1,1,1,1,True,True
7488,157,1,8,9,153,82,145,73,True,True
7489,157,2,7,18,159,139,152,121,True,True
7490,157,3,14,16,159,113,145,97,True,True
7491,157,4,10,12,119,105,109,93,True,True
7492,157,5,2,11,83,108,81,97,True,True
7493,157,6,2,21,104,120,102,99,True,True
7494,157,7,2,9,74,111,72,102,True,True
7495,157,8,4,10,58,120,54,110,True,True
7496,157,9,5,10,68,110,63,100,True,True
7497,157,10,3,10,58,93,55,83,True,True
7498,157,11,9,6,38,82,29,76,True,True
7499,157,12,7,12,34,54,27,42,True,True
7500,157,13,8,10,25,36,17,26,True,True
7501,157,14,5,5,18,27,13,22,True,True
7502,157,15,6,3,20,20,14,17,True,True
7503,157,16,8,5,19,22,11,17,True,True
7504,157,17,8,4,30,17,22,13,True,True
7505,157,18,9,3,15,10,6,7,True,True
7506,157,19,8,6,26,15,18,9,True,True
7507,157,20,2,2,28,9,26,7,True,True
7508,157,21,5,0,21,10,16,10,True,True
7509,157,22,3,1,23,9,20,8,True,True
7510,157,23,3,4,32,24,29,20,True,True
7511,157,24,8,4,27,14,19,10,True,True
7512,157,25,8,3,22,17,14,14,True,True
7513,157,26,6,3,26,22,20,19,True,True
7514,157,27,8,4,29,20,21,16,True,True
7515,157,28,7,5,27,23,20,18,True,True
7516,157,29,8,9,29,29,21,20,True,True
7517,157,30,11,7,40,28,29,21,True,True
7518,157,31,7,8,42,27,35,19,True,True
7519,157,32,9,9,38,32,29,23,True,True
7520,157,33,6,11,23,27,17,16,True,True
7521,157,34,6,10,32,32,26,22,True,True
7522,157,35,7,2,27,34,20,32,True,True
7523,157,36,7,3,42,31,35,28,True,True
7524,157,37,17,13,51,40,34,27,True,True
7525,157,38,10,10,43,43,33,33,True,True
7526,157,39,10,16,66,43,56,27,True,True
7527,157,40,12,14,91,50,79,36,True,True
7528,157,41,15,6,89,44,74,38,True,True
7529,157,42,13,11,101,36,88,25,True,True
7530,157,43,19,13,117,43,98,30,True,True
7531,157,44,16,7,121,34,105,27,True,True
7532,157,45,7,4,130,46,123,42,True,True
7533,157,46,6,10,154,68,148,58,True,True
7534,157,47,15,6,142,66,127,60,True,True
7535,157,48,9,11,163,64,154,53,True,True
7536,158,1,4367,3623,3113,3419,-1254,-204,False,False
7537,158,2,4239,3567,2515,3301,-1724,-266,False,False
7538,158,3,3910,3438,2023,2865,-1887,-573,False,False
7539,158,4,3377,3340,1410,2458,-1967,-882,False,False
7540,158,5,3123,3292,1078,1994,-2045,-1298,False,False
7541,158,6,2780,3344,744,1451,-2036,-1893,False,False
7542,158,7,2346,3492,531,1125,-1815,-2367,False,False
7543,158,8,1851,3246,334,721,-1517,-2525,False,False
7544,158,9,1290,2094,287,527,-1003,-1567,False,False
7545,158,10,468,717,178,264,-290,-453,False,False
7546,158,11,386,390,163,154,-223,-236,False,False
7547,158,12,614,238,257,112,-357,-126,False,False
7548,158,13,1049,200,353,124,-696,-76,False,False
7549,158,14,2236,225,656,136,-1580,-89,False,False
7550,158,15,2760,251,694,117,-2066,-134,False,False
7551,158,16,3091,331,979,251,-2112,-80,False,False
7552,158,17,3483,367,1797,313,-1686,-54,False,False
7553,158,18,3812,492,2032,446,-1780,-46,False,False
7554,158,19,4056,568,2464,550,-1592,-18,False,False
7555,158,20,3404,755,2172,723,-1232,-32,False,False
7556,158,21,2705,835,2058,876,-647,41,False,True
7557,158,22,2490,1084,2007,974,-483,-110,False,False
7558,158,23,2194,1035,2104,1154,-90,119,False,True
7559,158,24,2093,1208,2005,1289,-88,81,False,True
7560,158,25,2124,1238,2238,1483,114,245,True,True
7561,158,26,2202,1327,2291,1622,89,295,True,True
7562,158,27,2112,1285,2253,1572,141,287,True,True
7563,158,28,2217,1322,2131,1602,-86,280,False,True
7564,158,29,2210,1356,2204,1697,-6,341,False,True
7565,158,30,2215,1389,2282,1630,67,241,True,True
7566,158,31,2142,1363,2182,1589,40,226,True,True
7567,158,32,1835,1318,2155,1486,320,168,True,True
7568,158,33,1635,1193,2058,1458,423,265,True,True
7569,158,34,1510,1108,1949,1347,439,239,True,True
7570,158,35,2118,1329,2216,1412,98,83,True,True
7571,158,36,2557,1591,3004,1675,447,84,True,True
7572,158,37,3288,1792,4150,2043,862,251,True,True
7573,158,38,3995,1952,5231,2160,1236,208,True,True
7574,158,39,4269,1964,6127,2293,1858,329,True,True
7575,158,40,4480,2082,6561,2566,2081,484,True,True
7576,158,41,4562,1941,6354,2468,1792,527,True,True
7577,158,42,4580,1998,5819,2355,1239,357,True,True
7578,158,43,4749,2074,5363,2306,614,232,True,True
7579,158,44,4682,2131,4984,2422,302,291,True,True
7580,158,45,4582,2168,4669,2239,87,71,True,True
7581,158,46,4843,2317,4635,2325,-208,8,False,True
7582,158,47,4829,2622,4574,2549,-255,-73,False,False
7583,158,48,4944,2659,4500,2547,-444,-112,False,False
7584,159,1,5,4,62,29,57,25,True,True
7585,159,2,3,2,70,31,67,29,True,True
7586,159,3,5,3,62,46,57,43,True,True
7587,159,4,4,3,59,45,55,42,True,True
7588,159,5,1,2,47,46,46,44,True,True
7589,159,6,2,5,39,58,37,53,True,True
7590,159,7,4,3,27,48,23,45,True,True
7591,159,8,2,3,34,46,32,43,True,True
7592,159,9,5,7,25,49,20,42,True,True
7593,159,10,5,5,41,44,36,39,True,True
7594,159,11,6,3,38,26,32,23,True,True
7595,159,12,13,6,48,20,35,14,True,True
7596,159,13,14,1,25,14,11,13,True,True
7597,159,14,17,4,45,13,28,9,True,True
7598,159,15,6,2,47,23,41,21,True,True
7599,159,16,13,4,53,27,40,23,True,True
7600,159,17,4,4,36,26,32,22,True,True
7601,159,18,4,2,66,17,62,15,True,True
7602,159,19,6,3,41,13,35,10,True,True
7603,159,20,2,4,22,8,20,4,True,True
7604,159,21,1,3,17,9,16,6,True,True
7605,159,22,1,5,18,17,17,12,True,True
7606,159,23,1,4,22,15,21,11,True,True
7607,159,24,4,3,24,14,20,11,True,True
7608,159,25,2,3,21,12,19,9,True,True
7609,159,26,4,3,30,14,26,11,True,True
7610,159,27,4,1,17,4,13,3,True,True
7611,159,28,3,2,20,8,17,6,True,True
7612,159,29,1,1,10,8,9,7,True,True
7613,159,30,1,2,23,10,22,8,True,True
7614,159,31,1,0,14,21,13,21,True,True
7615,159,32,0,0,18,13,18,13,True,True
7616,159,33,1,2,19,15,18,13,True,True
7617,159,34,1,1,18,8,17,7,True,True
7618,159,35,5,0,15,9,10,9,True,True
7619,159,36,6,2,20,12,14,10,True,True
7620,159,37,3,0,28,14,25,14,True,True
7621,159,38,3,1,27,5,24,4,True,True
7622,159,39,1,0,23,5,22,5,True,True
7623,159,40,3,0,27,16,24,16,True,True
7624,159,41,1,0,21,9,20,9,True,True
7625,159,42,3,2,26,24,23,22,True,True
7626,159,43,5,1,36,13,31,12,True,True
7627,159,44,6,5,43,16,37,11,True,True
7628,159,45,2,5,62,21,60,16,True,True
7629,159,46,2,4,62,26,60,22,True,True
7630,159,47,5,2,51,24,46,22,True,True
7631,159,48,2,1,49,30,47,29,True,True
7632,160,1,1,3,123,75,122,72,True,True
7633,160,2,6,8,115,110,109,102,True,True
7634,160,3,5,11,108,91,103,80,True,True
7635,160,4,3,5,82,95,79,90,True,True
7636,160,5,5,8,72,80,67,72,True,True
7637,160,6,3,2,50,86,47,84,True,True
7638,160,7,0,6,41,95,41,89,True,True
7639,160,8,2,8,51,87,49,79,True,True
7640,160,9,4,4,32,77,28,73,True,True
7641,160,10,3,5,25,66,22,61,True,True
7642,160,11,2,7,16,43,14,36,True,True
7643,160,12,1,8,19,33,18,25,True,True
7644,160,13,0,1,9,15,9,14,True,True
7645,160,14,3,2,9,19,6,17,True,True
7646,160,15,4,3,15,7,11,4,True,True
7647,160,16,2,2,14,19,12,17,True,True
7648,160,17,2,2,10,17,8,15,True,True
7649,160,18,0,1,11,17,11,16,True,True
7650,160,19,1,1,19,14,18,13,True,True
7651,160,20,1,0,20,20,19,20,True,True
7652,160,21,3,0,18,16,15,16,True,True
7653,160,22,1,3,15,18,14,15,True,True
7654,160,23,3,3,18,9,15,6,True,True
7655,160,24,3,2,28,24,25,22,True,True
7656,160,25,1,4,23,17,22,13,True,True
7657,160,26,4,2,27,30,23,28,True,True
7658,160,27,1,1,25,19,24,18,True,True
7659,160,28,3,1,35,17,32,16,True,True
7660,160,29,5,1,19,20,14,19,True,True
7661,160,30,8,3,32,17,24,14,True,True
7662,160,31,3,5,24,13,21,8,True,True
7663,160,32,1,0,39,16,38,16,True,True
7664,160,33,2,3,23,21,21,18,True,True
7665,160,34,0,1,29,22,29,21,True,True
7666,160,35,2,2,19,32,17,30,True,True
7667,160,36,0,5,38,22,38,17,True,True
7668,160,37,2,1,35,26,33,25,True,True
7669,160,38,2,1,46,21,44,20,True,True
7670,160,39,3,1,63,32,60,31,True,True
7671,160,40,3,1,76,27,73,26,True,True
7672,160,41,4,2,89,26,85,24,True,True
7673,160,42,4,1,134,27,130,26,True,True
7674,160,43,3,0,126,32,123,32,True,True
7675,160,44,3,1,160,40,157,39,True,True
7676,160,45,3,1,154,43,151,42,True,True
7677,160,46,5,2,154,32,149,30,True,True
7678,160,47,4,4,158,53,154,49,True,True
7679,160,48,1,2,163,47,162,45,True,True
7680,161,1,5848,2790,2816,1995,-3032,-795,False,False
7681,161,2,4435,2297,2097,1850,-2338,-447,False,False
7682,161,3,3221,1768,1583,1694,-1638,-74,False,False
7683,161,4,2135,1392,1055,1407,-1080,15,False,True
7684,161,5,1704,1075,708,922,-996,-153,False,False
7685,161,6,1292,819,682,806,-610,-13,False,False
7686,161,7,982,770,532,737,-450,-33,False,False
7687,161,8,674,594,505,695,-169,101,False,True
7688,161,9,636,471,524,621,-112,150,False,True
7689,161,10,572,382,810,374,238,-8,True,False
7690,161,11,568,284,1284,318,716,34,True,True
7691,161,12,1107,296,3726,278,2619,-18,True,False
7692,161,13,1408,297,7105,352,5697,55,True,True
7693,161,14,2753,382,15150,667,12397,285,True,True
7694,161,15,3831,449,22794,713,18963,264,True,True
7695,161,16,5167,590,26268,1117,21101,527,True,True
7696,161,17,6334,746,25386,1259,19052,513,True,True
7697,161,18,8088,1043,25047,1898,16959,855,True,True
7698,161,19,8657,1396,22019,2334,13362,938,True,True
7699,161,20,9219,1827,19284,2886,10065,1059,True,True
7700,161,21,8692,2127,16698,3101,8006,974,True,True
7701,161,22,9603,2599,14528,3360,4925,761,True,True
7702,161,23,10258,2782,13399,3440,3141,658,True,True
7703,161,24,11897,3211,13536,3793,1639,582,True,True
7704,161,25,12282,3262,14305,3940,2023,678,True,True
7705,161,26,11592,3371,13246,3937,1654,566,True,True
7706,161,27,11103,3374,12083,3890,980,516,True,True
7707,161,28,11903,3576,12474,3915,571,339,True,True
7708,161,29,11981,3494,12404,3757,423,263,True,True
7709,161,30,11660,3663,11977,3922,317,259,True,True
7710,161,31,11032,3747,11257,3831,225,84,True,True
7711,161,32,9219,3745,10103,3851,884,106,True,True
7712,161,33,7503,3507,8556,3591,1053,84,True,True
7713,161,34,5902,2982,6884,3238,982,256,True,True
7714,161,35,5725,3263,6071,3096,346,-167,True,False
7715,161,36,7135,4132,7369,3418,234,-714,True,False
7716,161,37,8354,4525,8285,3139,-69,-1386,False,False
7717,161,38,9773,4513,8955,3053,-818,-1460,False,False
7718,161,39,10882,4507,8587,3088,-2295,-1419,False,False
7719,161,40,12460,4066,7845,3244,-4615,-822,False,False
7720,161,41,12825,3344,7084,2739,-5741,-605,False,False
7721,161,42,10718,2970,6301,2464,-4417,-506,False,False
7722,161,43,10191,2874,6266,2461,-3925,-413,False,False
7723,161,44,10853,2706,6143,2380,-4710,-326,False,False
7724,161,45,10521,2706,5933,2476,-4588,-230,False,False
7725,161,46,11122,3161,5187,2501,-5935,-660,False,False
7726,161,47,10552,3174,4495,2238,-6057,-936,False,False
7727,161,48,8134,2469,3817,1882,-4317,-587,False,False
7728,162,1,5393,3110,3400,2441,-1993,-669,False,False
7729,162,2,3881,2583,2633,2568,-1248,-15,False,False
7730,162,3,2812,2413,1918,2474,-894,61,False,True
7731,162,4,2043,1751,1486,2201,-557,450,False,True
7732,162,5,1524,1542,915,1482,-609,-60,False,False
7733,162,6,1228,1070,726,1343,-502,273,False,True
7734,162,7,862,907,546,1085,-316,178,False,True
7735,162,8,702,767,456,951,-246,184,False,True
7736,162,9,742,790,485,869,-257,79,False,True
7737,162,10,703,526,526,512,-177,-14,False,False
7738,162,11,703,422,721,449,18,27,True,True
7739,162,12,1454,424,2194,310,740,-114,True,False
7740,162,13,1914,488,4424,411,2510,-77,True,False
7741,162,14,3817,610,8575,575,4758,-35,True,False
7742,162,15,5319,687,14042,754,8723,67,True,True
7743,162,16,7019,1144,18505,1019,11486,-125,True,False
7744,162,17,8500,1120,17809,1199,9309,79,True,True
7745,162,18,10294,1676,16633,1713,6339,37,True,True
7746,162,19,9283,1844,15137,1930,5854,86,True,True
7747,162,20,8754,2377,13589,2397,4835,20,True,True
7748,162,21,8053,2570,11843,2413,3790,-157,True,False
7749,162,22,8603,2942,10847,3059,2244,117,True,True
7750,162,23,8533,3106,10109,2996,1576,-110,True,False
7751,162,24,9941,3420,9934,3326,-7,-94,False,False
7752,162,25,9914,3396,10054,3175,140,-221,True,False
7753,162,26,9064,3316,9409,3193,345,-123,True,False
7754,162,27,8818,3407,8824,3123,6,-284,True,False
7755,162,28,9620,3433,9058,3152,-562,-281,False,False
7756,162,29,9800,3254,9021,2976,-779,-278,False,False
7757,162,30,10017,3198,9191,3031,-826,-167,False,False
7758,162,31,8737,2995,8619,2921,-118,-74,False,False
7759,162,32,7564,3031,7458,2892,-106,-139,False,False
7760,162,33,5969,2655,6198,2829,229,174,True,True
7761,162,34,5095,2488,5181,2505,86,17,True,True
7762,162,35,6605,3199,5285,2450,-1320,-749,False,False
7763,162,36,8837,3992,6611,2920,-2226,-1072,False,False
7764,162,37,10808,3911,7686,3001,-3122,-910,False,False
7765,162,38,11679,4156,8428,2897,-3251,-1259,False,False
7766,162,39,12442,4097,8238,2799,-4204,-1298,False,False
7767,162,40,13067,4075,7709,2726,-5358,-1349,False,False
7768,162,41,13212,3392,7259,2607,-5953,-785,False,False
7769,162,42,12181,3529,6492,2484,-5689,-1045,False,False
7770,162,43,12640,3423,6441,2652,-6199,-771,False,False
7771,162,44,12999,3607,6477,2505,-6522,-1102,False,False
7772,162,45,11821,3194,6552,2706,-5269,-488,False,False
7773,162,46,11306,3140,6237,2655,-5069,-485,False,False
7774,162,47,9510,3171,5617,2766,-3893,-405,False,False
7775,162,48,7071,2615,4612,2360,-2459,-255,False,False
7776,163,1,4254,2608,2701,2035,-1553,-573,False,False
7777,163,2,3246,2271,2052,1894,-1194,-377,False,False
7778,163,3,2608,2125,1507,1673,-1101,-452,False,False
7779,163,4,1853,1866,1066,1421,-787,-445,False,False
7780,163,5,1469,1601,865,1233,-604,-368,False,False
7781,163,6,1072,1386,665,1102,-407,-284,False,False
7782,163,7,812,1294,452,898,-360,-396,False,False
7783,163,8,710,1182,361,685,-349,-497,False,False
7784,163,9,661,1129,355,595,-306,-534,False,False
7785,163,10,578,774,298,377,-280,-397,False,False
7786,163,11,558,353,433,222,-125,-131,False,False
7787,163,12,784,311,1192,201,408,-110,True,False
7788,163,13,1145,330,2237,242,1092,-88,True,False
7789,163,14,1906,405,3921,399,2015,-6,True,False
7790,163,15,2443,457,6446,480,4003,23,True,True
7791,163,16,3562,560,8576,743,5014,183,True,True
7792,163,17,4219,712,10284,808,6065,96,True,True
7793,163,18,5268,957,11516,1204,6248,247,True,True
7794,163,19,5286,1207,11340,1458,6054,251,True,True
7795,163,20,5911,1646,10495,1770,4584,124,True,True
7796,163,21,5854,1826,9456,2041,3602,215,True,True
7797,163,22,6365,2108,8450,2371,2085,263,True,True
7798,163,23,6432,2235,7962,2543,1530,308,True,True
7799,163,24,7229,2272,8040,2488,811,216,True,True
7800,163,25,7519,2408,8285,2763,766,355,True,True
7801,163,26,7505,2626,8253,2716,748,90,True,True
7802,163,27,7344,2950,7712,2799,368,-151,True,False
7803,163,28,8163,2911,7654,2796,-509,-115,False,False
7804,163,29,8331,2874,7569,2878,-762,4,False,True
7805,163,30,7909,3008,7304,3012,-605,4,False,True
7806,163,31,7248,2838,6785,2804,-463,-34,False,False
7807,163,32,6304,2738,6144,2565,-160,-173,False,False
7808,163,33,5142,2468,5300,2418,158,-50,True,False
7809,163,34,4072,2151,4327,2182,255,31,True,True
7810,163,35,4547,2176,4272,2038,-275,-138,False,False
7811,163,36,6328,2970,5074,2392,-1254,-578,False,False
7812,163,37,8359,3353,5556,2491,-2803,-862,False,False
7813,163,38,9494,3281,5773,2412,-3721,-869,False,False
7814,163,39,9658,3220,5471,2430,-4187,-790,False,False
7815,163,40,9750,2945,5144,2379,-4606,-566,False,False
7816,163,41,9616,2479,4910,2141,-4706,-338,False,False
7817,163,42,8321,2166,4389,2026,-3932,-140,False,False
7818,163,43,8100,2276,4608,2082,-3492,-194,False,False
7819,163,44,7808,2209,4731,2230,-3077,21,False,True
7820,163,45,7398,2258,4854,2201,-2544,-57,False,False
7821,163,46,6897,2118,4496,2102,-2401,-16,False,False
7822,163,47,6263,2196,4236,2000,-2027,-196,False,False
7823,163,48,5471,2065,3837,2000,-1634,-65,False,False
7824,164,1,4606,4032,3451,3186,-1155,-846,False,False
7825,164,2,3630,4029,2616,3007,-1014,-1022,False,False
7826,164,3,2777,3996,1916,2592,-861,-1404,False,False
7827,164,4,2098,3660,1347,2223,-751,-1437,False,False
7828,164,5,1526,3204,1058,2162,-468,-1042,False,False
7829,164,6,1214,2831,891,1989,-323,-842,False,False
7830,164,7,987,2497,674,1803,-313,-694,False,False
7831,164,8,802,2110,559,1537,-243,-573,False,False
7832,164,9,904,2025,485,1324,-419,-701,False,False
7833,164,10,831,1464,498,790,-333,-674,False,False
7834,164,11,764,1113,452,410,-312,-703,False,False
7835,164,12,1063,952,940,396,-123,-556,False,False
7836,164,13,1587,630,1530,280,-57,-350,False,False
7837,164,14,2476,551,2825,369,349,-182,True,False
7838,164,15,2991,522,3961,436,970,-86,True,False
7839,164,16,4272,711,5222,553,950,-158,True,False
7840,164,17,5122,794,6367,671,1245,-123,True,False
7841,164,18,6303,1013,7921,1012,1618,-1,True,False
7842,164,19,6450,1247,8546,1170,2096,-77,True,False
7843,164,20,6622,1581,8350,1631,1728,50,True,True
7844,164,21,5923,1715,7613,1834,1690,119,True,True
7845,164,22,5969,1960,6728,2096,759,136,True,True
7846,164,23,5936,2132,6675,2275,739,143,True,True
7847,164,24,6520,2221,6696,2293,176,72,True,True
7848,164,25,6712,2448,6892,2398,180,-50,True,False
7849,164,26,6584,2319,6901,2365,317,46,True,True
7850,164,27,6248,2412,6486,2360,238,-52,True,False
7851,164,28,6297,2320,6459,2275,162,-45,True,False
7852,164,29,6347,2350,6744,2250,397,-100,True,False
7853,164,30,6262,2270,6629,2198,367,-72,True,False
7854,164,31,5950,2280,6326,2412,376,132,True,True
7855,164,32,5274,2188,5961,2365,687,177,True,True
7856,164,33,4399,2080,5125,2295,726,215,True,True
7857,164,34,3845,1777,4257,1917,412,140,True,True
7858,164,35,3916,1832,3912,1997,-4,165,False,True
7859,164,36,4647,2476,4482,2420,-165,-56,False,False
7860,164,37,5164,2734,5087,2674,-77,-60,False,False
7861,164,38,5792,2909,5526,2763,-266,-146,False,False
7862,164,39,6698,3031,5886,2701,-812,-330,False,False
7863,164,40,7169,3033,6007,2724,-1162,-309,False,False
7864,164,41,7232,2790,6082,2688,-1150,-102,False,False
7865,164,42,7166,2865,6077,2605,-1089,-260,False,False
7866,164,43,7525,2732,6161,2763,-1364,31,False,True
7867,164,44,7116,2891,6003,2681,-1113,-210,False,False
7868,164,45,6784,2833,5931,2689,-853,-144,False,False
7869,164,46,6562,2922,5666,2818,-896,-104,False,False
7870,164,47,6734,2966,5245,2845,-1489,-121,False,False
7871,164,48,6397,2925,4990,2777,-1407,-148,False,False
7872,165,1,1,1,74,25,73,24,True,True
7873,165,2,5,1,83,24,78,23,True,True
7874,165,3,0,3,76,39,76,36,True,True
7875,165,4,4,5,67,50,63,45,True,True
7876,165,5,2,5,44,38,42,33,True,True
7877,165,6,3,1,31,46,28,45,True,True
7878,165,7,1,1,31,43,30,42,True,True
7879,165,8,5,6,19,51,14,45,True,True
7880,165,9,2,6,18,46,16,40,True,True
7881,165,10,2,7,18,34,16,27,True,True
7882,165,11,3,4,16,31,13,27,True,True
7883,165,12,5,4,10,22,5,18,True,True
7884,165,13,1,2,14,5,13,3,True,True
7885,165,14,6,1,16,9,10,8,True,True
7886,165,15,21,3,18,9,-3,6,False,True
7887,165,16,16,6,20,4,4,-2,True,False
7888,165,17,3,1,24,4,21,3,True,True
7889,165,18,7,0,29,6,22,6,True,True
7890,165,19,5,0,27,5,22,5,True,True
7891,165,20,6,2,18,9,12,7,True,True
7892,165,21,3,2,19,5,16,3,True,True
7893,165,22,5,3,28,12,23,9,True,True
7894,165,23,4,1,18,9,14,8,True,True
7895,165,24,3,2,20,9,17,7,True,True
7896,165,25,2,3,16,11,14,8,True,True
7897,165,26,4,2,30,7,26,5,True,True
7898,165,27,3,0,23,11,20,11,True,True
7899,165,28,2,1,22,14,20,13,True,True
7900,165,29,6,2,41,12,35,10,True,True
7901,165,30,4,1,33,17,29,16,True,True
7902,165,31,1,3,26,14,25,11,True,True
7903,165,32,6,1,32,7,26,6,True,True
7904,165,33,2,0,29,12,27,12,True,True
7905,165,34,4,2,16,6,12,4,True,True
7906,165,35,6,3,27,7,21,4,True,True
7907,165,36,6,1,21,11,15,10,True,True
7908,165,37,5,1,41,11,36,10,True,True
7909,165,38,2,2,38,14,36,12,True,True
7910,165,39,3,1,45,15,42,14,True,True
7911,165,40,5,0,68,9,63,9,True,True
7912,165,41,5,1,54,16,49,15,True,True
7913,165,42,4,2,58,16,54,14,True,True
7914,165,43,5,0,49,14,44,14,True,True
7915,165,44,4,1,76,10,72,9,True,True
7916,165,45,2,0,84,18,82,18,True,True
7917,165,46,3,0,81,27,78,27,True,True
7918,165,47,2,1,95,28,93,27,True,True
7919,165,48,3,1,95,23,92,22,True,True
7920,166,1,769,671,1245,728,476,57,True,True
7921,166,2,565,604,1036,785,471,181,True,True
7922,166,3,447,505,794,789,347,284,True,True
7923,166,4,351,395,612,855,261,460,True,True
7924,166,5,331,383,476,818,145,435,True,True
7925,166,6,230,318,384,826,154,508,True,True
7926,166,7,195,304,295,761,100,457,True,True
7927,166,8,167,231,225,645,58,414,True,True
7928,166,9,180,234,211,528,31,294,True,True
7929,166,10,178,155,150,375,-28,220,False,True
7930,166,11,274,141,132,214,-142,73,False,True
7931,166,12,367,130,217,138,-150,8,False,True
7932,166,13,436,153,283,110,-153,-43,False,False
7933,166,14,726,178,520,172,-206,-6,False,False
7934,166,15,987,256,816,190,-171,-66,False,False
7935,166,16,1559,316,1432,311,-127,-5,False,False
7936,166,17,1961,351,2231,439,270,88,True,True
7937,166,18,2020,476,2393,494,373,18,True,True
7938,166,19,1872,544,2211,481,339,-63,True,False
7939,166,20,1538,606,1871,579,333,-27,True,False
7940,166,21,1255,637,1541,619,286,-18,True,False
7941,166,22,1267,751,1438,755,171,4,True,True
7942,166,23,1248,671,1283,715,35,44,True,True
7943,166,24,1528,740,1315,697,-213,-43,False,False
7944,166,25,1652,742,1495,714,-157,-28,False,False
7945,166,26,1715,793,1652,792,-63,-1,False,False
7946,166,27,1519,766,1447,716,-72,-50,False,False
7947,166,28,1585,758,1557,685,-28,-73,False,False
7948,166,29,1528,752,1479,630,-49,-122,False,False
7949,166,30,1634,685,1605,689,-29,4,False,True
7950,166,31,1756,732,1581,754,-175,22,False,True
7951,166,32,1773,702,1503,655,-270,-47,False,False
7952,166,33,1653,659,1328,607,-325,-52,False,False
7953,166,34,1790,620,1282,614,-508,-6,False,False
7954,166,35,2291,653,1417,586,-874,-67,False,False
7955,166,36,2281,691,1733,684,-548,-7,False,False
7956,166,37,2202,701,1811,746,-391,45,False,True
7957,166,38,2143,737,1830,846,-313,109,False,True
7958,166,39,1800,664,1827,748,27,84,True,True
7959,166,40,1820,594,1694,616,-126,22,False,True
7960,166,41,1678,573,1563,616,-115,43,False,True
7961,166,42,1638,530,1595,542,-43,12,False,True
7962,166,43,1926,619,1734,650,-192,31,False,True
7963,166,44,1650,647,1774,636,124,-11,True,False
7964,166,45,1482,677,1845,695,363,18,True,True
7965,166,46,1222,654,1767,689,545,35,True,True
7966,166,47,1154,600,1605,715,451,115,True,True
7967,166,48,990,619,1444,727,454,108,True,True
7968,167,1,0,1,32,12,32,11,True,True
7969,167,2,1,1,33,21,32,20,True,True
7970,167,3,1,2,27,26,26,24,True,True
7971,167,4,0,2,28,25,28,23,True,True
7972,167,5,4,1,31,29,27,28,True,True
7973,167,6,1,0,14,38,13,38,True,True
7974,167,7,1,3,17,29,16,26,True,True
7975,167,8,1,1,22,20,21,19,True,True
7976,167,9,0,8,11,23,11,15,True,True
7977,167,10,0,0,10,21,10,21,True,True
7978,167,11,1,1,10,14,9,13,True,True
7979,167,12,2,2,11,12,9,10,True,True
7980,167,13,3,1,12,11,9,10,True,True
7981,167,14,5,1,6,7,1,6,True,True
7982,167,15,1,2,8,6,7,4,True,True
7983,167,16,5,0,17,12,12,12,True,True
7984,167,17,4,1,24,3,20,2,True,True
7985,167,18,2,2,13,10,11,8,True,True
7986,167,19,1,3,7,10,6,7,True,True
7987,167,20,2,3,12,8,10,5,True,True
7988,167,21,1,4,9,7,8,3,True,True
7989,167,22,4,3,9,6,5,3,True,True
7990,167,23,1,1,10,4,9,3,True,True
7991,167,24,1,4,13,8,12,4,True,True
7992,167,25,1,2,11,6,10,4,True,True
7993,167,26,2,1,6,6,4,5,True,True
7994,167,27,1,0,9,7,8,7,True,True
7995,167,28,3,1,7,4,4,3,True,True
7996,167,29,1,1,11,5,10,4,True,True
7997,167,30,2,0,12,9,10,9,True,True
7998,167,31,0,1,13,4,13,3,True,True
7999,167,32,0,0,7,7,7,7,True,True
8000,167,33,2,0,6,6,4,6,True,True
8001,167,34,1,0,10,3,9,3,True,True
8002,167,35,1,1,8,3,7,2,True,True
8003,167,36,3,2,14,10,11,8,True,True
8004,167,37,0,1,13,8,13,7,True,True
8005,167,38,0,2,7,12,7,10,True,True
8006,167,39,3,0,11,7,8,7,True,True
8007,167,40,0,1,16,10,16,9,True,True
8008,167,41,1,1,21,14,20,13,True,True
8009,167,42,1,0,21,10,20,10,True,True
8010,167,43,0,1,22,17,22,16,True,True
8011,167,44,1,0,22,8,21,8,True,True
8012,167,45,2,4,29,12,27,8,True,True
8013,167,46,1,0,19,14,18,14,True,True
8014,167,47,4,1,31,18,27,17,True,True
8015,167,48,0,1,27,24,27,23,True,True
8016,168,1,44,12,198,94,154,82,True,True
8017,168,2,33,24,187,114,154,90,True,True
8018,168,3,20,19,139,115,119,96,True,True
8019,168,4,29,19,120,131,91,112,True,True
8020,168,5,16,19,134,135,118,116,True,True
8021,168,6,21,21,118,133,97,112,True,True
8022,168,7,14,22,119,132,105,110,True,True
8023,168,8,21,15,95,109,74,94,True,True
8024,168,9,18,28,92,109,74,81,True,True
8025,168,10,16,19,94,102,78,83,True,True
8026,168,11,19,11,53,69,34,58,True,True
8027,168,12,38,14,52,69,14,55,True,True
8028,168,13,25,14,53,46,28,32,True,True
8029,168,14,36,20,91,42,55,22,True,True
8030,168,15,34,16,88,51,54,35,True,True
8031,168,16,32,14,131,42,99,28,True,True
8032,168,17,31,20,117,47,86,27,True,True
8033,168,18,43,16,85,42,42,26,True,True
8034,168,19,24,14,78,27,54,13,True,True
8035,168,20,35,18,87,43,52,25,True,True
8036,168,21,25,14,47,21,22,7,True,True
8037,168,22,21,16,61,37,40,21,True,True
8038,168,23,22,6,59,28,37,22,True,True
8039,168,24,21,18,62,37,41,19,True,True
8040,168,25,22,14,84,33,62,19,True,True
8041,168,26,21,9,74,36,53,27,True,True
8042,168,27,25,19,73,41,48,22,True,True
8043,168,28,20,13,72,28,52,15,True,True
8044,168,29,39,12,88,29,49,17,True,True
8045,168,30,20,9,64,40,44,31,True,True
8046,168,31,27,10,61,40,34,30,True,True
8047,168,32,31,10,67,37,36,27,True,True
8048,168,33,25,21,64,40,39,19,True,True
8049,168,34,38,14,49,39,11,25,True,True
8050,168,35,49,15,53,33,4,18,True,True
8051,168,36,60,30,62,45,2,15,True,True
8052,168,37,59,20,77,40,18,20,True,True
8053,168,38,42,18,109,35,67,17,True,True
8054,168,39,30,16,83,59,53,43,True,True
8055,168,40,41,15,89,52,48,37,True,True
8056,168,41,36,17,95,57,59,40,True,True
8057,168,42,32,12,123,45,91,33,True,True
8058,168,43,32,16,123,59,91,43,True,True
8059,168,44,30,25,141,65,111,40,True,True
8060,168,45,21,24,128,79,107,55,True,True
8061,168,46,24,23,129,71,105,48,True,True
8062,168,47,32,15,162,91,130,76,True,True
8063,168,48,22,23,174,106,152,83,True,True
8064,169,1,2,2,46,20,44,18,True,True
8065,169,2,4,2,57,39,53,37,True,True
8066,169,3,1,2,63,39,62,37,True,True
8067,169,4,4,2,53,41,49,39,True,True
8068,169,5,2,0,25,20,23,20,True,True
8069,169,6,3,3,43,25,40,22,True,True
8070,169,7,2,1,26,29,24,28,True,True
8071,169,8,0,2,22,34,22,32,True,True
8072,169,9,3,6,24,36,21,30,True,True
8073,169,10,6,4,25,53,19,49,True,True
8074,169,11,3,0,17,29,14,29,True,True
8075,169,12,0,0,9,32,9,32,True,True
8076,169,13,2,1,8,11,6,10,True,True
8077,169,14,5,3,15,7,10,4,True,True
8078,169,15,3,2,16,7,13,5,True,True
8079,169,16,4,1,23,7,19,6,True,True
8080,169,17,1,0,17,14,16,14,True,True
8081,169,18,0,1,17,7,17,6,True,True
8082,169,19,5,2,22,6,17,4,True,True
8083,169,20,5,3,14,6,9,3,True,True
8084,169,21,6,6,16,12,10,6,True,True
8085,169,22,3,3,14,10,11,7,True,True
8086,169,23,4,2,16,6,12,4,True,True
8087,169,24,2,4,13,13,11,9,True,True
8088,169,25,5,3,7,7,2,4,True,True
8089,169,26,3,2,5,3,2,1,True,True
8090,169,27,3,2,11,6,8,4,True,True
8091,169,28,2,1,17,11,15,10,True,True
8092,169,29,3,1,17,5,14,4,True,True
8093,169,30,2,0,15,5,13,5,True,True
8094,169,31,3,1,15,7,12,6,True,True
8095,169,32,2,0,10,5,8,5,True,True
8096,169,33,3,2,7,13,4,11,True,True
8097,169,34,3,3,10,10,7,7,True,True
8098,169,35,3,3,11,7,8,4,True,True
8099,169,36,3,5,11,15,8,10,True,True
8100,169,37,5,3,23,10,18,7,True,True
8101,169,38,6,3,26,14,20,11,True,True
8102,169,39,4,4,27,8,23,4,True,True
8103,169,40,0,2,19,8,19,6,True,True
8104,169,41,0,0,20,12,20,12,True,True
8105,169,42,2,2,30,10,28,8,True,True
8106,169,43,3,4,34,21,31,17,True,True
8107,169,44,1,1,26,16,25,15,True,True
8108,169,45,1,1,39,18,38,17,True,True
8109,169,46,1,1,30,16,29,15,True,True
8110,169,47,1,2,36,28,35,26,True,True
8111,169,48,2,3,47,28,45,25,True,True
8112,170,1,5184,4961,4982,4081,-202,-880,False,False
8113,170,2,3842,4632,3837,4203,-5,-429,False,False
8114,170,3,2691,4032,2794,4190,103,158,True,True
8115,170,4,1844,3379,2130,4271,286,892,True,True
8116,170,5,1382,3111,1484,3436,102,325,True,True
8117,170,6,1031,2522,1088,3115,57,593,True,True
8118,170,7,791,2146,896,2793,105,647,True,True
8119,170,8,630,1847,674,2083,44,236,True,True
8120,170,9,761,1441,667,1750,-94,309,False,True
8121,170,10,884,941,625,976,-259,35,False,True
8122,170,11,1031,707,675,794,-356,87,False,True
8123,170,12,2012,582,1637,481,-375,-101,False,False
8124,170,13,2904,608,3097,512,193,-96,True,False
8125,170,14,5738,775,5343,681,-395,-94,False,False
8126,170,15,7608,938,7260,749,-348,-189,False,False
8127,170,16,9951,1336,9453,1126,-498,-210,False,False
8128,170,17,10787,1388,10314,1272,-473,-116,False,False
8129,170,18,12106,1878,10630,1664,-1476,-214,False,False
8130,170,19,11094,2148,10423,1709,-671,-439,False,False
8131,170,20,10344,2789,10428,2332,84,-457,True,False
8132,170,21,8600,2851,9590,2542,990,-309,True,False
8133,170,22,8933,3383,9072,2908,139,-475,True,False
8134,170,23,8406,3353,8680,3056,274,-297,True,False
8135,170,24,8821,3637,8603,3251,-218,-386,False,False
8136,170,25,8658,3651,8575,3165,-83,-486,False,False
8137,170,26,8278,3610,8490,3158,212,-452,True,False
8138,170,27,7755,3392,7947,2917,192,-475,True,False
8139,170,28,8028,3258,8307,2973,279,-285,True,False
8140,170,29,8102,3084,8154,2890,52,-194,True,False
8141,170,30,8158,3210,8544,3056,386,-154,True,False
8142,170,31,7706,3111,8331,3243,625,132,True,True
8143,170,32,6973,3010,7756,3300,783,290,True,True
8144,170,33,5826,2700,6857,3049,1031,349,True,True
8145,170,34,5185,2675,5780,2836,595,161,True,True
8146,170,35,6277,2886,5858,2793,-419,-93,False,False
8147,170,36,7746,3533,7167,3393,-579,-140,False,False
8148,170,37,9102,3722,8362,3462,-740,-260,False,False
8149,170,38,10104,4134,9396,3560,-708,-574,False,False
8150,170,39,11179,4334,9686,3501,-1493,-833,False,False
8151,170,40,11443,4322,9859,3656,-1584,-666,False,False
8152,170,41,11267,3732,10166,3678,-1101,-54,False,False
8153,170,42,10654,3856,9614,3591,-1040,-265,False,False
8154,170,43,10681,3448,9557,3649,-1124,201,False,True
8155,170,44,9669,3525,9590,3730,-79,205,False,True
8156,170,45,9527,3422,9517,3914,-10,492,False,True
8157,170,46,8881,3685,8966,3843,85,158,True,True
8158,170,47,8412,3958,8514,3916,102,-42,True,False
8159,170,48,7207,3732,7360,3578,153,-154,True,False
8160,171,1,0,0,50,26,50,26,True,True
8161,171,2,2,1,54,26,52,25,True,True
8162,171,3,0,3,28,20,28,17,True,True
8163,171,4,1,0,32,37,31,37,True,True
8164,171,5,1,1,32,27,31,26,True,True
8165,171,6,1,0,22,35,21,35,True,True
8166,171,7,1,1,17,25,16,24,True,True
8167,171,8,1,2,8,21,7,19,True,True
8168,171,9,0,1,9,26,9,25,True,True
8169,171,10,0,1,12,21,12,20,True,True
8170,171,11,1,1,9,23,8,22,True,True
8171,171,12,2,4,10,14,8,10,True,True
8172,171,13,2,0,8,9,6,9,True,True
8173,171,14,1,1,11,4,10,3,True,True
8174,171,15,0,0,2,2,2,2,True,True
8175,171,16,2,2,9,6,7,4,True,True
8176,171,17,2,0,7,8,5,8,True,True
8177,171,18,1,1,10,7,9,6,True,True
8178,171,19,1,1,16,4,15,3,True,True
8179,171,20,0,0,13,14,13,14,True,True
8180,171,21,2,2,19,13,17,11,True,True
8181,171,22,0,1,10,12,10,11,True,True
8182,171,23,3,2,11,7,8,5,True,True
8183,171,24,3,0,15,4,12,4,True,True
8184,171,25,2,1,19,6,17,5,True,True
8185,171,26,1,0,17,8,16,8,True,True
8186,171,27,2,0,13,11,11,11,True,True
8187,171,28,0,1,10,8,10,7,True,True
8188,171,29,1,0,16,10,15,10,True,True
8189,171,30,1,4,21,9,20,5,True,True
8190,171,31,2,0,23,9,21,9,True,True
8191,171,32,1,1,24,6,23,5,True,True
8192,171,33,3,1,16,6,13,5,True,True
8193,171,34,2,0,10,13,8,13,True,True
8194,171,35,0,1,17,10,17,9,True,True
8195,171,36,1,0,31,10,30,10,True,True
8196,171,37,4,0,22,11,18,11,True,True
8197,171,38,1,0,24,11,23,11,True,True
8198,171,39,2,0,31,8,29,8,True,True
8199,171,40,0,0,23,19,23,19,True,True
8200,171,41,0,0,15,18,15,18,True,True
8201,171,42,4,1,30,13,26,12,True,True
8202,171,43,0,1,39,11,39,10,True,True
8203,171,44,1,0,49,16,48,16,True,True
8204,171,45,3,3,45,16,42,13,True,True
8205,171,46,4,2,52,21,48,19,True,True
8206,171,47,2,1,63,12,61,11,True,True
8207,171,48,3,1,55,18,52,17,True,True
8208,172,1,0,0,4,0,4,0,True,False
8209,172,2,0,0,2,5,2,5,True,True
8210,172,3,0,0,2,0,2,0,True,False
8211,172,4,0,0,3,6,3,6,True,True
8212,172,5,0,1,1,6,1,5,True,True
8213,172,6,0,1,1,5,1,4,True,True
8214,172,7,0,1,1,2,1,1,True,True
8215,172,8,0,0,2,4,2,4,True,True
8216,172,9,0,0,0,1,0,1,False,True
8217,172,10,0,0,0,2,0,2,False,True
8218,172,11,0,0,1,1,1,1,True,True
8219,172,12,0,0,0,0,0,0,False,False
8220,172,13,0,0,0,1,0,1,False,True
8221,172,14,0,0,1,1,1,1,True,True
8222,172,15,0,0,0,0,0,0,False,False
8223,172,16,0,0,0,0,0,0,False,False
8224,172,17,0,0,3,1,3,1,True,True
8225,172,18,0,0,2,3,2,3,True,True
8226,172,19,0,0,2,0,2,0,True,False
8227,172,20,0,0,1,0,1,0,True,False
8228,172,21,0,0,2,1,2,1,True,True
8229,172,22,0,0,1,1,1,1,True,True
8230,172,23,2,0,0,0,-2,0,False,False
8231,172,24,0,0,0,0,0,0,False,False
8232,172,25,1,0,1,0,0,0,False,False
8233,172,26,0,0,0,1,0,1,False,True
8234,172,27,2,0,1,0,-1,0,False,False
8235,172,28,0,0,1,0,1,0,True,False
8236,172,29,0,0,3,1,3,1,True,True
8237,172,30,0,0,4,1,4,1,True,True
8238,172,31,2,0,1,2,-1,2,False,True
8239,172,32,0,0,0,0,0,0,False,False
8240,172,33,0,0,1,1,1,1,True,True
8241,172,34,0,0,1,0,1,0,True,False
8242,172,35,0,0,1,1,1,1,True,True
8243,172,36,0,0,0,0,0,0,False,False
8244,172,37,0,0,1,0,1,0,True,False
8245,172,38,0,0,0,0,0,0,False,False
8246,172,39,0,0,4,0,4,0,True,False
8247,172,40,2,1,4,1,2,0,True,False
8248,172,41,0,0,1,1,1,1,True,True
8249,172,42,0,0,4,1,4,1,True,True
8250,172,43,0,0,4,2,4,2,True,True
8251,172,44,0,0,7,1,7,1,True,True
8252,172,45,0,0,4,1,4,1,True,True
8253,172,46,0,0,6,1,6,1,True,True
8254,172,47,0,0,5,0,5,0,True,False
8255,172,48,0,0,7,2,7,2,True,True
8256,173,1,2,7,97,48,95,41,True,True
8257,173,2,7,5,98,56,91,51,True,True
8258,173,3,5,11,126,90,121,79,True,True
8259,173,4,9,3,149,93,140,90,True,True
8260,173,5,4,7,100,96,96,89,True,True
8261,173,6,4,6,107,58,103,52,True,True
8262,173,7,7,13,83,86,76,73,True,True
8263,173,8,5,4,83,68,78,64,True,True
8264,173,9,4,11,70,68,66,57,True,True
8265,173,10,1,4,57,78,56,74,True,True
8266,173,11,3,4,37,67,34,63,True,True
8267,173,12,3,6,36,58,33,52,True,True
8268,173,13,1,4,31,33,30,29,True,True
8269,173,14,2,4,23,33,21,29,True,True
8270,173,15,0,3,18,19,18,16,True,True
8271,173,16,2,0,13,13,11,13,True,True
8272,173,17,0,2,7,14,7,12,True,True
8273,173,18,0,0,16,24,16,24,True,True
8274,173,19,0,0,15,14,15,14,True,True
8275,173,20,3,4,12,30,9,26,True,True
8276,173,21,1,5,16,24,15,19,True,True
8277,173,22,3,1,23,22,20,21,True,True
8278,173,23,1,3,17,12,16,9,True,True
8279,173,24,1,2,10,16,9,14,True,True
8280,173,25,1,3,7,13,6,10,True,True
8281,173,26,1,1,10,14,9,13,True,True
8282,173,27,0,0,13,14,13,14,True,True
8283,173,28,2,2,14,14,12,12,True,True
8284,173,29,2,2,23,15,21,13,True,True
8285,173,30,2,0,22,13,20,13,True,True
8286,173,31,0,1,24,7,24,6,True,True
8287,173,32,0,4,22,17,22,13,True,True
8288,173,33,3,1,17,26,14,25,True,True
8289,173,34,2,2,14,12,12,10,True,True
8290,173,35,8,1,21,16,13,15,True,True
8291,173,36,3,1,17,18,14,17,True,True
8292,173,37,5,0,28,11,23,11,True,True
8293,173,38,8,0,27,12,19,12,True,True
8294,173,39,3,1,31,17,28,16,True,True
8295,173,40,3,1,36,20,33,19,True,True
8296,173,41,2,1,38,20,36,19,True,True
8297,173,42,2,1,32,15,30,14,True,True
8298,173,43,3,2,39,21,36,19,True,True
8299,173,44,2,6,41,27,39,21,True,True
8300,173,45,2,2,40,24,38,22,True,True
8301,173,46,3,4,58,37,55,33,True,True
8302,173,47,6,3,63,43,57,40,True,True
8303,173,48,3,5,75,63,72,58,True,True
8304,174,1,1,1,40,18,39,17,True,True
8305,174,2,0,1,27,21,27,20,True,True
8306,174,3,2,1,36,26,34,25,True,True
8307,174,4,0,0,31,26,31,26,True,True
8308,174,5,0,0,18,30,18,30,True,True
8309,174,6,0,1,15,21,15,20,True,True
8310,174,7,0,0,19,23,19,23,True,True
8311,174,8,0,2,12,22,12,20,True,True
8312,174,9,1,0,12,22,11,22,True,True
8313,174,10,0,1,16,20,16,19,True,True
8314,174,11,0,1,15,18,15,17,True,True
8315,174,12,2,0,17,15,15,15,True,True
8316,174,13,1,0,36,11,35,11,True,True
8317,174,14,0,1,36,13,36,12,True,True
8318,174,15,2,1,39,8,37,7,True,True
8319,174,16,0,0,26,13,26,13,True,True
8320,174,17,2,2,26,9,24,7,True,True
8321,174,18,3,0,16,8,13,8,True,True
8322,174,19,1,1,23,2,22,1,True,True
8323,174,20,4,0,27,9,23,9,True,True
8324,174,21,1,0,17,3,16,3,True,True
8325,174,22,0,0,10,6,10,6,True,True
8326,174,23,0,2,6,9,6,7,True,True
8327,174,24,1,1,17,11,16,10,True,True
8328,174,25,0,0,12,3,12,3,True,True
8329,174,26,0,0,8,4,8,4,True,True
8330,174,27,2,0,17,3,15,3,True,True
8331,174,28,2,0,14,4,12,4,True,True
8332,174,29,1,0,9,5,8,5,True,True
8333,174,30,1,0,13,5,12,5,True,True
8334,174,31,0,0,8,3,8,3,True,True
8335,174,32,2,0,13,4,11,4,True,True
8336,174,33,0,0,8,5,8,5,True,True
8337,174,34,1,0,10,5,9,5,True,True
8338,174,35,3,0,10,5,7,5,True,True
8339,174,36,1,0,14,5,13,5,True,True
8340,174,37,0,0,8,6,8,6,True,True
8341,174,38,1,0,18,9,17,9,True,True
8342,174,39,2,0,20,7,18,7,True,True
8343,174,40,0,0,13,8,13,8,True,True
8344,174,41,1,0,22,7,21,7,True,True
8345,174,42,0,0,20,6,20,6,True,True
8346,174,43,1,1,20,15,19,14,True,True
8347,174,44,1,1,36,15,35,14,True,True
8348,174,45,3,1,35,10,32,9,True,True
8349,174,46,2,3,32,18,30,15,True,True
8350,174,47,1,2,46,15,45,13,True,True
8351,174,48,1,1,42,20,41,19,True,True
8352,175,1,0,1,25,13,25,12,True,True
8353,175,2,0,0,14,20,14,20,True,True
8354,175,3,0,0,15,16,15,16,True,True
8355,175,4,1,0,17,14,16,14,True,True
8356,175,5,0,1,11,19,11,18,True,True
8357,175,6,0,0,9,12,9,12,True,True
8358,175,7,0,0,6,8,6,8,True,True
8359,175,8,0,0,4,9,4,9,True,True
8360,175,9,0,1,2,7,2,6,True,True
8361,175,10,1,2,4,10,3,8,True,True
8362,175,11,0,0,5,5,5,5,True,True
8363,175,12,1,0,4,3,3,3,True,True
8364,175,13,0,0,7,2,7,2,True,True
8365,175,14,0,0,5,2,5,2,True,True
8366,175,15,0,0,5,2,5,2,True,True
8367,175,16,0,0,3,6,3,6,True,True
8368,175,17,0,0,8,4,8,4,True,True
8369,175,18,0,0,7,3,7,3,True,True
8370,175,19,0,0,9,5,9,5,True,True
8371,175,20,0,0,8,2,8,2,True,True
8372,175,21,0,0,4,3,4,3,True,True
8373,175,22,0,0,5,5,5,5,True,True
8374,175,23,0,1,10,4,10,3,True,True
8375,175,24,0,0,5,4,5,4,True,True
8376,175,25,0,0,9,5,9,5,True,True
8377,175,26,0,0,7,5,7,5,True,True
8378,175,27,0,0,8,1,8,1,True,True
8379,175,28,1,0,5,4,4,4,True,True
8380,175,29,1,0,11,1,10,1,True,True
8381,175,30,0,0,8,6,8,6,True,True
8382,175,31,0,0,10,4,10,4,True,True
8383,175,32,0,0,7,9,7,9,True,True
8384,175,33,0,1,9,2,9,1,True,True
8385,175,34,0,0,8,4,8,4,True,True
8386,175,35,0,0,11,5,11,5,True,True
8387,175,36,0,0,12,4,12,4,True,True
8388,175,37,1,0,12,8,11,8,True,True
8389,175,38,1,0,16,6,15,6,True,True
8390,175,39,4,0,17,6,13,6,True,True
8391,175,40,2,0,24,3,22,3,True,True
8392,175,41,0,0,19,9,19,9,True,True
8393,175,42,0,0,35,14,35,14,True,True
8394,175,43,0,0,27,11,27,11,True,True
8395,175,44,1,0,28,4,27,4,True,True
8396,175,45,1,0,29,8,28,8,True,True
8397,175,46,1,1,31,12,30,11,True,True
8398,175,47,0,2,30,10,30,8,True,True
8399,175,48,0,3,35,7,35,4,True,True
8400,176,1,0,0,1,1,1,1,True,True
8401,176,2,0,0,2,1,2,1,True,True
8402,176,3,0,0,1,2,1,2,True,True
8403,176,4,0,0,3,1,3,1,True,True
8404,176,5,0,0,3,0,3,0,True,False
8405,176,6,0,0,1,4,1,4,True,True
8406,176,7,0,1,0,3,0,2,False,True
8407,176,8,0,0,0,2,0,2,False,True
8408,176,9,0,0,0,0,0,0,False,False
8409,176,10,0,0,0,1,0,1,False,True
8410,176,11,0,0,0,1,0,1,False,True
8411,176,12,0,0,0,0,0,0,False,False
8412,176,13,0,0,0,1,0,1,False,True
8413,176,14,0,0,1,0,1,0,True,False
8414,176,15,0,0,1,0,1,0,True,False
8415,176,16,0,0,0,0,0,0,False,False
8416,176,17,0,0,0,0,0,0,False,False
8417,176,18,0,0,0,0,0,0,False,False
8418,176,19,0,0,0,1,0,1,False,True
8419,176,20,0,0,0,0,0,0,False,False
8420,176,21,0,0,0,0,0,0,False,False
8421,176,22,0,0,0,1,0,1,False,True
8422,176,23,0,0,0,0,0,0,False,False
8423,176,24,0,0,0,0,0,0,False,False
8424,176,25,0,0,0,0,0,0,False,False
8425,176,26,0,0,0,0,0,0,False,False
8426,176,27,0,0,1,0,1,0,True,False
8427,176,28,0,0,0,0,0,0,False,False
8428,176,29,0,0,0,0,0,0,False,False
8429,176,30,0,0,1,0,1,0,True,False
8430,176,31,0,0,0,0,0,0,False,False
8431,176,32,0,0,0,1,0,1,False,True
8432,176,33,0,0,1,0,1,0,True,False
8433,176,34,0,0,2,0,2,0,True,False
8434,176,35,0,0,0,0,0,0,False,False
8435,176,36,0,0,2,0,2,0,True,False
8436,176,37,1,0,0,1,-1,1,False,True
8437,176,38,0,0,1,1,1,1,True,True
8438,176,39,0,0,0,0,0,0,False,False
8439,176,40,0,0,1,1,1,1,True,True
8440,176,41,0,0,2,0,2,0,True,False
8441,176,42,1,0,1,0,0,0,False,False
8442,176,43,0,0,0,0,0,0,False,False
8443,176,44,0,0,3,1,3,1,True,True
8444,176,45,0,0,0,0,0,0,False,False
8445,176,46,0,0,3,0,3,0,True,False
8446,176,47,0,0,3,1,3,1,True,True
8447,176,48,0,0,2,1,2,1,True,True
8448,177,1,1,4,50,27,49,23,True,True
8449,177,2,4,0,54,34,50,34,True,True
8450,177,3,3,4,57,35,54,31,True,True
8451,177,4,5,4,55,42,50,38,True,True
8452,177,5,1,5,58,45,57,40,True,True
8453,177,6,10,5,51,42,41,37,True,True
8454,177,7,2,5,40,55,38,50,True,True
8455,177,8,1,6,30,52,29,46,True,True
8456,177,9,3,5,31,49,28,44,True,True
8457,177,10,3,6,25,51,22,45,True,True
8458,177,11,7,4,33,40,26,36,True,True
8459,177,12,3,4,14,21,11,17,True,True
8460,177,13,6,1,9,15,3,14,True,True
8461,177,14,3,3,13,9,10,6,True,True
8462,177,15,1,3,11,7,10,4,True,True
8463,177,16,3,1,6,5,3,4,True,True
8464,177,17,2,1,10,4,8,3,True,True
8465,177,18,1,1,11,12,10,11,True,True
8466,177,19,2,1,12,4,10,3,True,True
8467,177,20,1,0,6,4,5,4,True,True
8468,177,21,1,0,5,5,4,5,True,True
8469,177,22,0,1,7,9,7,8,True,True
8470,177,23,1,2,10,7,9,5,True,True
8471,177,24,1,2,5,9,4,7,True,True
8472,177,25,2,2,7,8,5,6,True,True
8473,177,26,1,0,10,4,9,4,True,True
8474,177,27,1,3,7,6,6,3,True,True
8475,177,28,0,0,6,2,6,2,True,True
8476,177,29,0,1,8,7,8,6,True,True
8477,177,30,1,0,11,3,10,3,True,True
8478,177,31,1,1,10,13,9,12,True,True
8479,177,32,0,1,12,2,12,1,True,True
8480,177,33,2,0,9,5,7,5,True,True
8481,177,34,1,0,9,3,8,3,True,True
8482,177,35,0,0,13,5,13,5,True,True
8483,177,36,2,0,11,11,9,11,True,True
8484,177,37,3,1,14,12,11,11,True,True
8485,177,38,2,0,11,9,9,9,True,True
8486,177,39,0,1,20,13,20,12,True,True
8487,177,40,4,1,13,12,9,11,True,True
8488,177,41,0,1,19,13,19,12,True,True
8489,177,42,2,0,19,14,17,14,True,True
8490,177,43,1,1,17,15,16,14,True,True
8491,177,44,1,0,31,9,30,9,True,True
8492,177,45,0,1,41,18,41,17,True,True
8493,177,46,3,4,35,20,32,16,True,True
8494,177,47,3,4,33,23,30,19,True,True
8495,177,48,2,1,47,26,45,25,True,True
8496,178,1,1,2,41,8,40,6,True,True
8497,178,2,2,1,32,7,30,6,True,True
8498,178,3,5,0,23,14,18,14,True,True
8499,178,4,3,1,28,18,25,17,True,True
8500,178,5,3,2,13,13,10,11,True,True
8501,178,6,3,1,17,14,14,13,True,True
8502,178,7,2,2,9,24,7,22,True,True
8503,178,8,2,4,10,16,8,12,True,True
8504,178,9,1,3,2,17,1,14,True,True
8505,178,10,10,5,10,19,0,14,False,True
8506,178,11,11,11,19,9,8,-2,True,False
8507,178,12,4,7,8,8,4,1,True,True
8508,178,13,4,2,4,8,0,6,False,True
8509,178,14,5,1,5,1,0,0,False,False
8510,178,15,6,1,3,5,-3,4,False,True
8511,178,16,3,1,8,1,5,0,True,False
8512,178,17,2,1,6,2,4,1,True,True
8513,178,18,1,0,12,2,11,2,True,True
8514,178,19,2,0,5,2,3,2,True,True
8515,178,20,0,2,5,2,5,0,True,False
8516,178,21,3,1,8,1,5,0,True,False
8517,178,22,0,2,4,7,4,5,True,True
8518,178,23,0,0,2,0,2,0,True,False
8519,178,24,0,1,9,3,9,2,True,True
8520,178,25,2,1,14,3,12,2,True,True
8521,178,26,1,0,11,7,10,7,True,True
8522,178,27,4,0,15,6,11,6,True,True
8523,178,28,0,0,12,5,12,5,True,True
8524,178,29,2,2,13,3,11,1,True,True
8525,178,30,1,0,12,4,11,4,True,True
8526,178,31,6,2,14,5,8,3,True,True
8527,178,32,3,2,15,5,12,3,True,True
8528,178,33,18,3,31,7,13,4,True,True
8529,178,34,2,7,16,4,14,-3,True,False
8530,178,35,13,2,18,6,5,4,True,True
8531,178,36,10,1,14,6,4,5,True,True
8532,178,37,1,2,8,7,7,5,True,True
8533,178,38,3,2,13,4,10,2,True,True
8534,178,39,2,0,13,11,11,11,True,True
8535,178,40,3,3,34,11,31,8,True,True
8536,178,41,2,6,31,6,29,0,True,False
8537,178,42,5,3,35,10,30,7,True,True
8538,178,43,4,3,25,7,21,4,True,True
8539,178,44,5,0,24,6,19,6,True,True
8540,178,45,1,2,23,12,22,10,True,True
8541,178,46,7,4,36,13,29,9,True,True
8542,178,47,3,1,40,7,37,6,True,True
8543,178,48,2,2,45,15,43,13,True,True
8544,179,1,182,182,877,409,695,227,True,True
8545,179,2,153,201,896,547,743,346,True,True
8546,179,3,156,202,796,583,640,381,True,True
8547,179,4,131,166,572,560,441,394,True,True
8548,179,5,110,186,485,547,375,361,True,True
8549,179,6,106,152,355,497,249,345,True,True
8550,179,7,75,154,329,481,254,327,True,True
8551,179,8,47,160,234,427,187,267,True,True
8552,179,9,95,116,266,380,171,264,True,True
8553,179,10,147,92,211,335,64,243,True,True
8554,179,11,119,59,120,196,1,137,True,True
8555,179,12,184,79,118,163,-66,84,False,True
8556,179,13,207,96,53,103,-154,7,False,True
8557,179,14,309,93,81,71,-228,-22,False,False
8558,179,15,355,103,96,50,-259,-53,False,False
8559,179,16,422,104,117,74,-305,-30,False,False
8560,179,17,404,139,91,67,-313,-72,False,False
8561,179,18,354,120,93,62,-261,-58,False,False
8562,179,19,317,165,88,61,-229,-104,False,False
8563,179,20,180,160,83,56,-97,-104,False,False
8564,179,21,174,126,74,62,-100,-64,False,False
8565,179,22,160,129,96,61,-64,-68,False,False
8566,179,23,152,115,104,79,-48,-36,False,False
8567,179,24,151,114,100,56,-51,-58,False,False
8568,179,25,108,124,85,72,-23,-52,False,False
8569,179,26,125,96,127,66,2,-30,True,False
8570,179,27,112,93,114,76,2,-17,True,False
8571,179,28,107,103,120,72,13,-31,True,False
8572,179,29,99,82,115,62,16,-20,True,False
8573,179,30,80,89,131,83,51,-6,True,False
8574,179,31,90,88,112,84,22,-4,True,False
8575,179,32,84,75,115,84,31,9,True,True
8576,179,33,99,75,136,80,37,5,True,True
8577,179,34,83,72,119,79,36,7,True,True
8578,179,35,86,52,140,94,54,42,True,True
8579,179,36,126,81,200,101,74,20,True,True
8580,179,37,151,99,233,91,82,-8,True,False
8581,179,38,117,69,223,136,106,67,True,True
8582,179,39,127,80,319,125,192,45,True,True
8583,179,40,109,90,319,115,210,25,True,True
8584,179,41,99,81,348,134,249,53,True,True
8585,179,42,112,79,383,152,271,73,True,True
8586,179,43,133,90,450,173,317,83,True,True
8587,179,44,129,88,538,197,409,109,True,True
8588,179,45,156,92,606,209,450,117,True,True
8589,179,46,154,111,745,247,591,136,True,True
8590,179,47,187,140,820,294,633,154,True,True
8591,179,48,177,117,906,343,729,226,True,True
8592,180,1,3,0,23,20,20,20,True,True
8593,180,2,1,1,38,15,37,14,True,True
8594,180,3,2,0,30,17,28,17,True,True
8595,180,4,2,0,21,15,19,15,True,True
8596,180,5,2,2,14,23,12,21,True,True
8597,180,6,0,0,16,22,16,22,True,True
8598,180,7,1,1,11,15,10,14,True,True
8599,180,8,2,1,16,17,14,16,True,True
8600,180,9,1,0,8,12,7,12,True,True
8601,180,10,0,0,11,13,11,13,True,True
8602,180,11,1,1,10,12,9,11,True,True
8603,180,12,0,1,4,8,4,7,True,True
8604,180,13,1,1,7,7,6,6,True,True
8605,180,14,0,1,4,7,4,6,True,True
8606,180,15,0,1,8,7,8,6,True,True
8607,180,16,0,0,4,6,4,6,True,True
8608,180,17,4,0,3,2,-1,2,False,True
8609,180,18,0,0,6,5,6,5,True,True
8610,180,19,1,0,6,5,5,5,True,True
8611,180,20,1,1,7,2,6,1,True,True
8612,180,21,1,0,5,3,4,3,True,True
8613,180,22,2,1,11,1,9,0,True,False
8614,180,23,3,1,8,2,5,1,True,True
8615,180,24,5,0,4,2,-1,2,False,True
8616,180,25,0,0,6,2,6,2,True,True
8617,180,26,1,0,7,2,6,2,True,True
8618,180,27,1,0,7,3,6,3,True,True
8619,180,28,3,2,4,5,1,3,True,True
8620,180,29,5,0,10,4,5,4,True,True
8621,180,30,4,2,9,2,5,0,True,False
8622,180,31,2,0,8,5,6,5,True,True
8623,180,32,5,5,12,6,7,1,True,True
8624,180,33,4,4,12,8,8,4,True,True
8625,180,34,2,3,10,6,8,3,True,True
8626,180,35,3,0,10,5,7,5,True,True
8627,180,36,2,2,12,5,10,3,True,True
8628,180,37,6,1,11,11,5,10,True,True
8629,180,38,1,0,10,13,9,13,True,True
8630,180,39,1,0,20,9,19,9,True,True
8631,180,40,1,1,29,1,28,0,True,False
8632,180,41,0,0,20,8,20,8,True,True
8633,180,42,1,1,22,10,21,9,True,True
8634,180,43,2,0,20,4,18,4,True,True
8635,180,44,1,0,28,9,27,9,True,True
8636,180,45,0,0,24,7,24,7,True,True
8637,180,46,1,2,27,14,26,12,True,True
8638,180,47,1,0,33,8,32,8,True,True
8639,180,48,4,2,42,15,38,13,True,True
8640,181,1,1087,1187,2126,1060,1039,-127,True,False
8641,181,2,866,1238,2051,1270,1185,32,True,True
8642,181,3,580,1104,1628,1328,1048,224,True,True
8643,181,4,418,970,1071,1252,653,282,True,True
8644,181,5,349,786,840,1227,491,441,True,True
8645,181,6,221,665,591,1109,370,444,True,True
8646,181,7,166,506,431,934,265,428,True,True
8647,181,8,105,387,370,780,265,393,True,True
8648,181,9,82,293,302,620,220,327,True,True
8649,181,10,81,179,221,461,140,282,True,True
8650,181,11,83,87,158,240,75,153,True,True
8651,181,12,151,61,135,161,-16,100,False,True
8652,181,13,155,56,137,140,-18,84,False,True
8653,181,14,250,64,135,117,-115,53,False,True
8654,181,15,281,71,159,77,-122,6,False,True
8655,181,16,244,72,166,81,-78,9,False,True
8656,181,17,271,98,219,102,-52,4,False,True
8657,181,18,225,92,169,118,-56,26,False,True
8658,181,19,155,110,184,167,29,57,True,True
8659,181,20,131,146,188,169,57,23,True,True
8660,181,21,102,123,171,202,69,79,True,True
8661,181,22,108,163,173,245,65,82,True,True
8662,181,23,105,152,203,289,98,137,True,True
8663,181,24,95,153,222,255,127,102,True,True
8664,181,25,106,150,253,275,147,125,True,True
8665,181,26,87,194,279,280,192,86,True,True
8666,181,27,95,166,267,280,172,114,True,True
8667,181,28,90,151,345,277,255,126,True,True
8668,181,29,92,184,309,320,217,136,True,True
8669,181,30,99,185,347,321,248,136,True,True
8670,181,31,104,189,386,357,282,168,True,True
8671,181,32,119,194,342,363,223,169,True,True
8672,181,33,100,172,310,323,210,151,True,True
8673,181,34,103,168,327,335,224,167,True,True
8674,181,35,176,231,369,395,193,164,True,True
8675,181,36,166,268,464,403,298,135,True,True
8676,181,37,244,306,654,516,410,210,True,True
8677,181,38,314,352,932,518,618,166,True,True
8678,181,39,415,354,1225,621,810,267,True,True
8679,181,40,479,346,1382,638,903,292,True,True
8680,181,41,558,334,1622,714,1064,380,True,True
8681,181,42,627,378,1759,617,1132,239,True,True
8682,181,43,751,336,1983,585,1232,249,True,True
8683,181,44,976,479,2269,667,1293,188,True,True
8684,181,45,1206,558,2514,750,1308,192,True,True
8685,181,46,1361,648,2514,766,1153,118,True,True
8686,181,47,1482,717,2532,818,1050,101,True,True
8687,181,48,1445,837,2456,895,1011,58,True,True
8688,182,1,2,1,39,22,37,21,True,True
8689,182,2,0,3,50,38,50,35,True,True
8690,182,3,2,2,42,42,40,40,True,True
8691,182,4,0,7,29,36,29,29,True,True
8692,182,5,0,4,27,45,27,41,True,True
8693,182,6,1,2,17,29,16,27,True,True
8694,182,7,0,3,17,26,17,23,True,True
8695,182,8,1,3,10,40,9,37,True,True
8696,182,9,1,0,14,28,13,28,True,True
8697,182,10,1,2,10,18,9,16,True,True
8698,182,11,0,2,10,10,10,8,True,True
8699,182,12,1,1,6,13,5,12,True,True
8700,182,13,0,0,7,8,7,8,True,True
8701,182,14,2,5,8,8,6,3,True,True
8702,182,15,0,0,5,3,5,3,True,True
8703,182,16,1,3,4,4,3,1,True,True
8704,182,17,0,0,5,1,5,1,True,True
8705,182,18,0,0,7,4,7,4,True,True
8706,182,19,1,2,9,5,8,3,True,True
8707,182,20,0,0,4,4,4,4,True,True
8708,182,21,1,0,10,8,9,8,True,True
8709,182,22,2,1,11,6,9,5,True,True
8710,182,23,0,2,7,8,7,6,True,True
8711,182,24,1,0,8,4,7,4,True,True
8712,182,25,2,3,6,7,4,4,True,True
8713,182,26,1,1,10,7,9,6,True,True
8714,182,27,1,2,7,5,6,3,True,True
8715,182,28,0,0,14,5,14,5,True,True
8716,182,29,0,0,9,5,9,5,True,True
8717,182,30,1,2,12,10,11,8,True,True
8718,182,31,0,3,7,6,7,3,True,True
8719,182,32,0,1,11,10,11,9,True,True
8720,182,33,1,0,11,9,10,9,True,True
8721,182,34,0,0,6,10,6,10,True,True
8722,182,35,1,0,9,10,8,10,True,True
8723,182,36,3,1,10,6,7,5,True,True
8724,182,37,1,0,12,13,11,13,True,True
8725,182,38,0,1,8,8,8,7,True,True
8726,182,39,1,0,16,9,15,9,True,True
8727,182,40,0,1,23,10,23,9,True,True
8728,182,41,2,1,22,14,20,13,True,True
8729,182,42,0,0,45,7,45,7,True,True
8730,182,43,4,0,29,17,25,17,True,True
8731,182,44,1,0,43,13,42,13,True,True
8732,182,45,2,0,35,14,33,14,True,True
8733,182,46,0,1,56,15,56,14,True,True
8734,182,47,2,1,52,17,50,16,True,True
8735,182,48,2,0,47,16,45,16,True,True
8736,183,1,0,0,21,10,21,10,True,True
8737,183,2,0,2,8,9,8,7,True,True
8738,183,3,0,2,15,11,15,9,True,True
8739,183,4,0,1,13,11,13,10,True,True
8740,183,5,1,0,14,14,13,14,True,True
8741,183,6,0,0,10,13,10,13,True,True
8742,183,7,0,0,8,14,8,14,True,True
8743,183,8,0,1,3,13,3,12,True,True
8744,183,9,0,0,5,8,5,8,True,True
8745,183,10,0,0,5,14,5,14,True,True
8746,183,11,0,1,6,6,6,5,True,True
8747,183,12,0,0,0,1,0,1,False,True
8748,183,13,0,0,3,6,3,6,True,True
8749,183,14,0,0,4,6,4,6,True,True
8750,183,15,0,0,2,1,2,1,True,True
8751,183,16,0,0,1,0,1,0,True,False
8752,183,17,0,0,5,1,5,1,True,True
8753,183,18,0,0,2,3,2,3,True,True
8754,183,19,1,0,5,1,4,1,True,True
8755,183,20,0,0,3,2,3,2,True,True
8756,183,21,0,0,3,5,3,5,True,True
8757,183,22,0,0,3,2,3,2,True,True
8758,183,23,0,0,3,2,3,2,True,True
8759,183,24,0,0,3,1,3,1,True,True
8760,183,25,0,0,7,0,7,0,True,False
8761,183,26,0,0,3,1,3,1,True,True
8762,183,27,0,0,8,3,8,3,True,True
8763,183,28,0,0,3,1,3,1,True,True
8764,183,29,0,0,4,1,4,1,True,True
8765,183,30,0,0,2,2,2,2,True,True
8766,183,31,0,0,7,2,7,2,True,True
8767,183,32,0,0,8,6,8,6,True,True
8768,183,33,0,0,3,5,3,5,True,True
8769,183,34,0,0,1,3,1,3,True,True
8770,183,35,0,0,2,4,2,4,True,True
8771,183,36,0,0,2,6,2,6,True,True
8772,183,37,0,0,4,2,4,2,True,True
8773,183,38,0,0,2,0,2,0,True,False
8774,183,39,0,0,5,2,5,2,True,True
8775,183,40,0,0,11,4,11,4,True,True
8776,183,41,1,0,11,3,10,3,True,True
8777,183,42,0,0,20,4,20,4,True,True
8778,183,43,0,0,22,4,22,4,True,True
8779,183,44,0,0,23,6,23,6,True,True
8780,183,45,0,0,22,5,22,5,True,True
8781,183,46,1,0,17,7,16,7,True,True
8782,183,47,0,0,19,2,19,2,True,True
8783,183,48,0,0,27,10,27,10,True,True
8784,184,1,0,0,3,1,3,1,True,True
8785,184,2,1,0,4,2,3,2,True,True
8786,184,3,0,0,1,0,1,0,True,False
8787,184,4,1,0,3,0,2,0,True,False
8788,184,5,1,0,1,4,0,4,False,True
8789,184,6,0,0,1,1,1,1,True,True
8790,184,7,0,1,2,8,2,7,True,True
8791,184,8,0,1,2,3,2,2,True,True
8792,184,9,0,0,2,3,2,3,True,True
8793,184,10,0,0,0,2,0,2,False,True
8794,184,11,0,0,0,6,0,6,False,True
8795,184,12,0,0,0,4,0,4,False,True
8796,184,13,0,0,1,1,1,1,True,True
8797,184,14,0,0,0,3,0,3,False,True
8798,184,15,0,0,1,1,1,1,True,True
8799,184,16,0,0,3,1,3,1,True,True
8800,184,17,2,0,2,3,0,3,False,True
8801,184,18,2,1,3,1,1,0,True,False
8802,184,19,2,0,2,1,0,1,False,True
8803,184,20,1,0,2,2,1,2,True,True
8804,184,21,2,0,3,1,1,1,True,True
8805,184,22,2,0,2,1,0,1,False,True
8806,184,23,1,0,3,0,2,0,True,False
8807,184,24,0,0,4,1,4,1,True,True
8808,184,25,0,1,3,0,3,-1,True,False
8809,184,26,0,0,2,3,2,3,True,True
8810,184,27,0,1,1,2,1,1,True,True
8811,184,28,0,0,1,1,1,1,True,True
8812,184,29,0,0,2,1,2,1,True,True
8813,184,30,0,0,3,1,3,1,True,True
8814,184,31,0,1,0,2,0,1,False,True
8815,184,32,0,0,0,1,0,1,False,True
8816,184,33,0,0,4,2,4,2,True,True
8817,184,34,0,0,2,1,2,1,True,True
8818,184,35,0,0,1,0,1,0,True,False
8819,184,36,0,0,0,0,0,0,False,False
8820,184,37,2,0,3,1,1,1,True,True
8821,184,38,1,1,0,0,-1,-1,False,False
8822,184,39,1,1,0,2,-1,1,False,True
8823,184,40,0,1,1,1,1,0,True,False
8824,184,41,0,0,1,0,1,0,True,False
8825,184,42,0,0,1,1,1,1,True,True
8826,184,43,1,0,3,0,2,0,True,False
8827,184,44,0,0,7,1,7,1,True,True
8828,184,45,1,0,2,2,1,2,True,True
8829,184,46,0,1,4,0,4,-1,True,False
8830,184,47,0,1,7,1,7,0,True,False
8831,184,48,0,0,3,2,3,2,True,True
8832,185,1,2,0,45,23,43,23,True,True
8833,185,2,2,1,46,22,44,21,True,True
8834,185,3,1,2,29,37,28,35,True,True
8835,185,4,1,0,22,38,21,38,True,True
8836,185,5,0,0,31,50,31,50,True,True
8837,185,6,0,1,15,33,15,32,True,True
8838,185,7,0,0,10,42,10,42,True,True
8839,185,8,0,2,15,29,15,27,True,True
8840,185,9,1,1,13,23,12,22,True,True
8841,185,10,0,3,10,28,10,25,True,True
8842,185,11,0,1,5,16,5,15,True,True
8843,185,12,1,1,4,11,3,10,True,True
8844,185,13,0,0,8,7,8,7,True,True
8845,185,14,0,0,15,7,15,7,True,True
8846,185,15,0,2,14,4,14,2,True,True
8847,185,16,1,1,12,7,11,6,True,True
8848,185,17,1,0,11,15,10,15,True,True
8849,185,18,1,0,15,5,14,5,True,True
8850,185,19,0,0,24,6,24,6,True,True
8851,185,20,1,1,27,4,26,3,True,True
8852,185,21,0,0,22,3,22,3,True,True
8853,185,22,1,0,12,1,11,1,True,True
8854,185,23,0,0,12,8,12,8,True,True
8855,185,24,0,0,9,8,9,8,True,True
8856,185,25,0,0,14,7,14,7,True,True
8857,185,26,3,1,14,5,11,4,True,True
8858,185,27,1,0,15,6,14,6,True,True
8859,185,28,0,0,8,8,8,8,True,True
8860,185,29,0,0,9,7,9,7,True,True
8861,185,30,0,0,12,6,12,6,True,True
8862,185,31,0,0,14,5,14,5,True,True
8863,185,32,2,0,8,8,6,8,True,True
8864,185,33,1,0,16,6,15,6,True,True
8865,185,34,0,0,11,8,11,8,True,True
8866,185,35,0,2,11,7,11,5,True,True
8867,185,36,1,0,8,8,7,8,True,True
8868,185,37,1,2,9,6,8,4,True,True
8869,185,38,0,0,16,8,16,8,True,True
8870,185,39,0,1,11,16,11,15,True,True
8871,185,40,1,2,18,14,17,12,True,True
8872,185,41,2,0,21,16,19,16,True,True
8873,185,42,0,0,16,15,16,15,True,True
8874,185,43,2,0,32,12,30,12,True,True
8875,185,44,1,0,39,17,38,17,True,True
8876,185,45,0,0,36,13,36,13,True,True
8877,185,46,2,2,48,20,46,18,True,True
8878,185,47,1,1,47,20,46,19,True,True
8879,185,48,4,0,53,25,49,25,True,True
8880,186,1,4319,2952,3383,2926,-936,-26,False,False
8881,186,2,3300,2666,2908,3245,-392,579,False,True
8882,186,3,2325,2345,2344,3085,19,740,True,True
8883,186,4,1578,1821,1140,2444,-438,623,False,True
8884,186,5,1409,1485,1007,2528,-402,1043,False,True
8885,186,6,896,1216,1138,2792,242,1576,True,True
8886,186,7,646,915,684,1406,38,491,True,True
8887,186,8,458,761,562,1590,104,829,True,True
8888,186,9,652,713,798,1510,146,797,True,True
8889,186,10,879,615,987,1041,108,426,True,True
8890,186,11,965,640,1806,763,841,123,True,True
8891,186,12,2811,453,3128,934,317,481,True,True
8892,186,13,5924,456,3354,1454,-2570,998,False,True
8893,186,14,7915,1152,5244,1929,-2671,777,False,True
8894,186,15,9536,752,5529,2021,-4007,1269,False,True
8895,186,16,9540,1266,6187,2838,-3353,1572,False,True
8896,186,17,8975,931,5137,2757,-3838,1826,False,True
8897,186,18,8923,1831,5679,3800,-3244,1969,False,True
8898,186,19,8768,1380,6177,3647,-2591,2267,False,True
8899,186,20,8728,2436,6453,4693,-2275,2257,False,True
8900,186,21,7989,2033,6275,3820,-1714,1787,False,True
8901,186,22,7917,3142,6120,4281,-1797,1139,False,True
8902,186,23,7730,2990,6123,4144,-1607,1154,False,True
8903,186,24,7180,3590,6128,4134,-1052,544,False,True
8904,186,25,6952,3513,6091,3611,-861,98,False,True
8905,186,26,7101,3743,5959,3687,-1142,-56,False,False
8906,186,27,6800,3779,6306,3388,-494,-391,False,False
8907,186,28,6858,3683,6796,3576,-62,-107,False,False
8908,186,29,7173,3295,7197,3600,24,305,True,True
8909,186,30,7212,3885,7826,3928,614,43,True,True
8910,186,31,6542,3551,8015,3417,1473,-134,True,False
8911,186,32,6536,3417,7891,3847,1355,430,True,True
8912,186,33,5077,2932,6580,3399,1503,467,True,True
8913,186,34,4694,2929,5687,3252,993,323,True,True
8914,186,35,5153,2641,5533,2709,380,68,True,True
8915,186,36,6075,3708,6278,3286,203,-422,True,False
8916,186,37,6822,3714,6634,2989,-188,-725,False,False
8917,186,38,7059,4790,6559,3205,-500,-1585,False,False
8918,186,39,8546,4694,6892,2850,-1654,-1844,False,False
8919,186,40,8665,5796,6715,2847,-1950,-2949,False,False
8920,186,41,8381,4339,7091,2344,-1290,-1995,False,False
8921,186,42,7698,5201,7178,2629,-520,-2572,False,False
8922,186,43,7518,4046,7032,2342,-486,-1704,False,False
8923,186,44,6963,5320,7147,2488,184,-2832,True,False
8924,186,45,5944,3901,6450,2377,506,-1524,True,False
8925,186,46,6307,5075,6030,2695,-277,-2380,False,False
8926,186,47,5178,3931,5168,2366,-10,-1565,False,False
8927,186,48,4421,3774,5027,2404,606,-1370,True,False
8928,187,1,0,0,0,0,0,0,False,False
8929,187,2,0,0,0,0,0,0,False,False
8930,187,3,0,0,0,0,0,0,False,False
8931,187,4,0,0,0,4,0,4,False,True
8932,187,5,1,1,1,2,0,1,False,True
8933,187,6,0,0,0,0,0,0,False,False
8934,187,7,0,0,0,1,0,1,False,True
8935,187,8,0,0,1,0,1,0,True,False
8936,187,9,0,0,1,0,1,0,True,False
8937,187,10,0,0,1,1,1,1,True,True
8938,187,11,0,0,0,2,0,2,False,True
8939,187,12,0,0,0,1,0,1,False,True
8940,187,13,0,0,1,1,1,1,True,True
8941,187,14,0,0,0,1,0,1,False,True
8942,187,15,0,0,1,0,1,0,True,False
8943,187,16,0,0,0,0,0,0,False,False
8944,187,17,0,0,0,0,0,0,False,False
8945,187,18,0,0,0,1,0,1,False,True
8946,187,19,0,0,0,1,0,1,False,True
8947,187,20,0,0,0,0,0,0,False,False
8948,187,21,0,0,0,0,0,0,False,False
8949,187,22,0,0,0,0,0,0,False,False
8950,187,23,0,0,0,0,0,0,False,False
8951,187,24,0,0,0,0,0,0,False,False
8952,187,25,0,0,0,0,0,0,False,False
8953,187,26,0,0,0,0,0,0,False,False
8954,187,27,0,0,1,0,1,0,True,False
8955,187,28,0,0,1,0,1,0,True,False
8956,187,29,0,0,0,0,0,0,False,False
8957,187,30,0,0,1,0,1,0,True,False
8958,187,31,0,0,0,0,0,0,False,False
8959,187,32,0,0,2,0,2,0,True,False
8960,187,33,0,0,0,0,0,0,False,False
8961,187,34,0,0,1,0,1,0,True,False
8962,187,35,0,0,0,0,0,0,False,False
8963,187,36,0,0,1,0,1,0,True,False
8964,187,37,0,0,0,2,0,2,False,True
8965,187,38,0,0,2,0,2,0,True,False
8966,187,39,0,0,1,0,1,0,True,False
8967,187,40,0,0,1,0,1,0,True,False
8968,187,41,0,0,3,0,3,0,True,False
8969,187,42,0,0,5,0,5,0,True,False
8970,187,43,0,0,7,0,7,0,True,False
8971,187,44,0,0,1,3,1,3,True,True
8972,187,45,0,0,1,2,1,2,True,True
8973,187,46,0,0,0,1,0,1,False,True
8974,187,47,0,0,3,0,3,0,True,False
8975,187,48,0,0,1,0,1,0,True,False
8976,188,1,37,32,404,161,367,129,True,True
8977,188,2,33,36,384,198,351,162,True,True
8978,188,3,36,36,418,248,382,212,True,True
8979,188,4,47,43,278,299,231,256,True,True
8980,188,5,29,27,277,265,248,238,True,True
8981,188,6,28,25,214,277,186,252,True,True
8982,188,7,14,40,178,289,164,249,True,True
8983,188,8,12,25,165,249,153,224,True,True
8984,188,9,16,30,121,220,105,190,True,True
8985,188,10,17,27,130,210,113,183,True,True
8986,188,11,23,23,79,139,56,116,True,True
8987,188,12,32,12,51,76,19,64,True,True
8988,188,13,38,12,46,56,8,44,True,True
8989,188,14,35,14,42,36,7,22,True,True
8990,188,15,25,15,42,19,17,4,True,True
8991,188,16,20,12,30,32,10,20,True,True
8992,188,17,18,15,33,28,15,13,True,True
8993,188,18,8,9,43,22,35,13,True,True
8994,188,19,9,9,24,18,15,9,True,True
8995,188,20,10,16,29,27,19,11,True,True
8996,188,21,6,11,40,20,34,9,True,True
8997,188,22,10,13,21,26,11,13,True,True
8998,188,23,5,19,31,23,26,4,True,True
8999,188,24,8,13,33,28,25,15,True,True
9000,188,25,4,16,29,25,25,9,True,True
9001,188,26,9,8,37,23,28,15,True,True
9002,188,27,4,11,32,31,28,20,True,True
9003,188,28,4,12,37,21,33,9,True,True
9004,188,29,8,10,39,23,31,13,True,True
9005,188,30,4,7,55,30,51,23,True,True
9006,188,31,8,5,40,30,32,25,True,True
9007,188,32,9,8,45,31,36,23,True,True
9008,188,33,10,8,46,23,36,15,True,True
9009,188,34,9,8,41,40,32,32,True,True
9010,188,35,13,14,49,33,36,19,True,True
9011,188,36,11,8,48,30,37,22,True,True
9012,188,37,6,14,57,55,51,41,True,True
9013,188,38,23,14,84,37,61,23,True,True
9014,188,39,12,25,81,48,69,23,True,True
9015,188,40,16,12,111,62,95,50,True,True
9016,188,41,17,13,134,63,117,50,True,True
9017,188,42,14,12,132,78,118,66,True,True
9018,188,43,14,17,197,64,183,47,True,True
9019,188,44,30,20,215,73,185,53,True,True
9020,188,45,26,17,250,114,224,97,True,True
9021,188,46,37,27,297,113,260,86,True,True
9022,188,47,33,32,340,144,307,112,True,True
9023,188,48,49,29,418,157,369,128,True,True
9024,189,1,221,300,835,432,614,132,True,True
9025,189,2,178,244,736,477,558,233,True,True
9026,189,3,141,283,550,492,409,209,True,True
9027,189,4,90,193,434,478,344,285,True,True
9028,189,5,68,164,293,450,225,286,True,True
9029,189,6,41,147,211,419,170,272,True,True
9030,189,7,34,117,155,354,121,237,True,True
9031,189,8,26,48,129,281,103,233,True,True
9032,189,9,26,56,113,233,87,177,True,True
9033,189,10,24,30,89,159,65,129,True,True
9034,189,11,12,23,67,99,55,76,True,True
9035,189,12,31,16,49,62,18,46,True,True
9036,189,13,43,11,36,51,-7,40,False,True
9037,189,14,52,18,36,31,-16,13,False,True
9038,189,15,67,11,30,17,-37,6,False,True
9039,189,16,55,16,32,28,-23,12,False,True
9040,189,17,59,23,33,22,-26,-1,False,False
9041,189,18,61,34,44,30,-17,-4,False,False
9042,189,19,34,24,46,33,12,9,True,True
9043,189,20,43,31,45,36,2,5,True,True
9044,189,21,25,38,41,49,16,11,True,True
9045,189,22,27,41,40,64,13,23,True,True
9046,189,23,23,47,47,57,24,10,True,True
9047,189,24,23,38,68,75,45,37,True,True
9048,189,25,25,41,58,84,33,43,True,True
9049,189,26,18,46,60,76,42,30,True,True
9050,189,27,25,42,76,74,51,32,True,True
9051,189,28,24,37,83,86,59,49,True,True
9052,189,29,27,44,91,84,64,40,True,True
9053,189,30,24,43,72,81,48,38,True,True
9054,189,31,28,36,71,94,43,58,True,True
9055,189,32,25,42,64,77,39,35,True,True
9056,189,33,23,56,85,77,62,21,True,True
9057,189,34,21,45,93,84,72,39,True,True
9058,189,35,29,47,79,101,50,54,True,True
9059,189,36,40,47,127,109,87,62,True,True
9060,189,37,51,50,169,122,118,72,True,True
9061,189,38,60,75,230,169,170,94,True,True
9062,189,39,83,81,271,153,188,72,True,True
9063,189,40,100,62,362,153,262,91,True,True
9064,189,41,121,71,413,172,292,101,True,True
9065,189,42,133,63,472,157,339,94,True,True
9066,189,43,152,81,625,163,473,82,True,True
9067,189,44,204,86,753,188,549,102,True,True
9068,189,45,270,107,734,236,464,129,True,True
9069,189,46,280,127,830,290,550,163,True,True
9070,189,47,317,174,860,285,543,111,True,True
9071,189,48,335,175,883,332,548,157,True,True
9072,190,1,19,31,98,60,79,29,True,True
9073,190,2,11,28,109,75,98,47,True,True
9074,190,3,9,26,118,73,109,47,True,True
9075,190,4,11,20,92,77,81,57,True,True
9076,190,5,10,15,75,97,65,82,True,True
9077,190,6,5,15,55,95,50,80,True,True
9078,190,7,6,9,43,78,37,69,True,True
9079,190,8,5,6,29,61,24,55,True,True
9080,190,9,0,3,32,63,32,60,True,True
9081,190,10,5,6,19,34,14,28,True,True
9082,190,11,5,6,10,25,5,19,True,True
9083,190,12,6,4,12,12,6,8,True,True
9084,190,13,7,1,9,11,2,10,True,True
9085,190,14,5,3,4,6,-1,3,False,True
9086,190,15,11,4,9,6,-2,2,False,True
9087,190,16,8,2,10,11,2,9,True,True
9088,190,17,8,5,9,3,1,-2,True,False
9089,190,18,3,12,17,16,14,4,True,True
9090,190,19,4,8,11,15,7,7,True,True
9091,190,20,2,4,10,24,8,20,True,True
9092,190,21,7,2,21,27,14,25,True,True
9093,190,22,3,8,23,46,20,38,True,True
9094,190,23,3,11,19,43,16,32,True,True
9095,190,24,5,12,21,51,16,39,True,True
9096,190,25,3,11,25,47,22,36,True,True
9097,190,26,5,21,22,39,17,18,True,True
9098,190,27,11,27,15,44,4,17,True,True
9099,190,28,7,18,27,51,20,33,True,True
9100,190,29,2,21,22,49,20,28,True,True
9101,190,30,13,23,21,40,8,17,True,True
9102,190,31,13,25,16,35,3,10,True,True
9103,190,32,4,19,18,34,14,15,True,True
9104,190,33,11,15,13,32,2,17,True,True
9105,190,34,5,24,18,25,13,1,True,True
9106,190,35,15,25,20,17,5,-8,True,False
9107,190,36,11,23,25,39,14,16,True,True
9108,190,37,11,28,26,44,15,16,True,True
9109,190,38,7,20,54,52,47,32,True,True
9110,190,39,7,16,54,34,47,18,True,True
9111,190,40,18,14,50,33,32,19,True,True
9112,190,41,13,12,58,22,45,10,True,True
9113,190,42,20,14,55,25,35,11,True,True
9114,190,43,32,10,69,27,37,17,True,True
9115,190,44,19,16,79,26,60,10,True,True
9116,190,45,26,13,90,22,64,9,True,True
9117,190,46,21,19,93,27,72,8,True,True
9118,190,47,28,34,104,41,76,7,True,True
9119,190,48,28,23,117,53,89,30,True,True
9120,191,1,1,1,28,16,27,15,True,True
9121,191,2,2,0,31,16,29,16,True,True
9122,191,3,2,0,29,13,27,13,True,True
9123,191,4,4,0,16,9,12,9,True,True
9124,191,5,0,0,11,17,11,17,True,True
9125,191,6,2,1,9,16,7,15,True,True
9126,191,7,1,0,11,8,10,8,True,True
9127,191,8,2,1,9,8,7,7,True,True
9128,191,9,2,0,6,18,4,18,True,True
9129,191,10,4,2,9,11,5,9,True,True
9130,191,11,2,4,5,10,3,6,True,True
9131,191,12,1,1,6,7,5,6,True,True
9132,191,13,1,1,9,8,8,7,True,True
9133,191,14,1,0,7,6,6,6,True,True
9134,191,15,1,2,4,8,3,6,True,True
9135,191,16,0,1,6,1,6,0,True,False
9136,191,17,0,0,6,7,6,7,True,True
9137,191,18,3,0,8,1,5,1,True,True
9138,191,19,1,1,9,4,8,3,True,True
9139,191,20,2,0,13,4,11,4,True,True
9140,191,21,2,0,13,7,11,7,True,True
9141,191,22,0,0,20,6,20,6,True,True
9142,191,23,0,1,13,6,13,5,True,True
9143,191,24,1,0,8,8,7,8,True,True
9144,191,25,2,1,11,10,9,9,True,True
9145,191,26,0,1,15,8,15,7,True,True
9146,191,27,0,0,10,4,10,4,True,True
9147,191,28,2,1,13,4,11,3,True,True
9148,191,29,0,0,11,7,11,7,True,True
9149,191,30,0,2,14,10,14,8,True,True
9150,191,31,1,1,14,9,13,8,True,True
9151,191,32,1,0,8,9,7,9,True,True
9152,191,33,6,1,24,8,18,7,True,True
9153,191,34,2,0,14,7,12,7,True,True
9154,191,35,2,1,19,7,17,6,True,True
9155,191,36,2,1,8,8,6,7,True,True
9156,191,37,1,0,20,6,19,6,True,True
9157,191,38,1,0,14,11,13,11,True,True
9158,191,39,0,0,18,6,18,6,True,True
9159,191,40,1,1,22,9,21,8,True,True
9160,191,41,1,1,20,9,19,8,True,True
9161,191,42,1,2,23,13,22,11,True,True
9162,191,43,2,2,17,13,15,11,True,True
9163,191,44,1,3,30,18,29,15,True,True
9164,191,45,0,0,32,12,32,12,True,True
9165,191,46,0,1,41,11,41,10,True,True
9166,191,47,0,0,37,13,37,13,True,True
9167,191,48,2,0,33,10,31,10,True,True
9168,192,1,4,0,33,18,29,18,True,True
9169,192,2,2,1,23,22,21,21,True,True
9170,192,3,0,0,21,18,21,18,True,True
9171,192,4,2,2,22,12,20,10,True,True
9172,192,5,3,1,20,12,17,11,True,True
9173,192,6,3,0,10,19,7,19,True,True
9174,192,7,2,1,9,13,7,12,True,True
9175,192,8,0,4,4,18,4,14,True,True
9176,192,9,1,2,6,16,5,14,True,True
9177,192,10,2,3,4,15,2,12,True,True
9178,192,11,0,3,5,9,5,6,True,True
9179,192,12,2,0,7,5,5,5,True,True
9180,192,13,3,1,11,13,8,12,True,True
9181,192,14,1,2,15,10,14,8,True,True
9182,192,15,2,0,10,9,8,9,True,True
9183,192,16,6,4,21,8,15,4,True,True
9184,192,17,3,2,23,9,20,7,True,True
9185,192,18,2,2,13,9,11,7,True,True
9186,192,19,3,1,18,7,15,6,True,True
9187,192,20,1,0,11,12,10,12,True,True
9188,192,21,3,0,11,8,8,8,True,True
9189,192,22,3,2,15,7,12,5,True,True
9190,192,23,1,3,13,11,12,8,True,True
9191,192,24,0,3,9,7,9,4,True,True
9192,192,25,3,3,12,11,9,8,True,True
9193,192,26,1,3,18,11,17,8,True,True
9194,192,27,2,0,8,7,6,7,True,True
9195,192,28,0,2,11,8,11,6,True,True
9196,192,29,2,3,15,6,13,3,True,True
9197,192,30,6,0,15,7,9,7,True,True
9198,192,31,2,2,12,10,10,8,True,True
9199,192,32,3,1,13,6,10,5,True,True
9200,192,33,1,4,15,7,14,3,True,True
9201,192,34,1,4,9,8,8,4,True,True
9202,192,35,5,2,10,8,5,6,True,True
9203,192,36,1,2,12,7,11,5,True,True
9204,192,37,4,1,13,6,9,5,True,True
9205,192,38,2,0,15,6,13,6,True,True
9206,192,39,4,3,14,4,10,1,True,True
9207,192,40,0,0,11,3,11,3,True,True
9208,192,41,3,1,22,6,19,5,True,True
9209,192,42,0,0,18,7,18,7,True,True
9210,192,43,1,0,23,4,22,4,True,True
9211,192,44,3,0,28,12,25,12,True,True
9212,192,45,3,0,34,19,31,19,True,True
9213,192,46,0,0,42,7,42,7,True,True
9214,192,47,4,2,22,11,18,9,True,True
9215,192,48,3,2,40,18,37,16,True,True
9216,193,1,75,30,95,71,20,41,True,True
9217,193,2,62,41,130,70,68,29,True,True
9218,193,3,64,48,119,95,55,47,True,True
9219,193,4,25,29,81,75,56,46,True,True
9220,193,5,29,28,69,81,40,53,True,True
9221,193,6,16,29,44,71,28,42,True,True
9222,193,7,20,27,49,73,29,46,True,True
9223,193,8,28,26,45,63,17,37,True,True
9224,193,9,19,25,52,65,33,40,True,True
9225,193,10,49,15,30,61,-19,46,False,True
9226,193,11,57,33,27,39,-30,6,False,True
9227,193,12,93,32,32,42,-61,10,False,True
9228,193,13,115,39,56,28,-59,-11,False,False
9229,193,14,122,65,67,23,-55,-42,False,False
9230,193,15,147,44,117,25,-30,-19,False,False
9231,193,16,210,41,156,21,-54,-20,False,False
9232,193,17,190,50,139,31,-51,-19,False,False
9233,193,18,130,57,127,34,-3,-23,False,False
9234,193,19,110,44,134,39,24,-5,True,False
9235,193,20,77,54,93,51,16,-3,True,False
9236,193,21,86,54,92,57,6,3,True,True
9237,193,22,68,54,75,34,7,-20,True,False
9238,193,23,64,52,72,40,8,-12,True,False
9239,193,24,50,44,61,35,11,-9,True,False
9240,193,25,67,36,71,41,4,5,True,True
9241,193,26,62,33,80,36,18,3,True,True
9242,193,27,67,40,69,32,2,-8,True,False
9243,193,28,51,33,47,38,-4,5,False,True
9244,193,29,60,38,70,34,10,-4,True,False
9245,193,30,50,28,64,33,14,5,True,True
9246,193,31,44,28,66,50,22,22,True,True
9247,193,32,45,18,54,36,9,18,True,True
9248,193,33,32,27,56,32,24,5,True,True
9249,193,34,36,42,68,37,32,-5,True,False
9250,193,35,52,30,82,34,30,4,True,True
9251,193,36,66,31,84,32,18,1,True,True
9252,193,37,53,26,70,36,17,10,True,True
9253,193,38,59,28,81,32,22,4,True,True
9254,193,39,51,20,74,36,23,16,True,True
9255,193,40,54,27,89,33,35,6,True,True
9256,193,41,46,27,64,35,18,8,True,True
9257,193,42,43,27,71,28,28,1,True,True
9258,193,43,57,33,97,41,40,8,True,True
9259,193,44,60,30,108,34,48,4,True,True
9260,193,45,50,32,131,46,81,14,True,True
9261,193,46,117,34,115,66,-2,32,False,True
9262,193,47,110,34,132,57,22,23,True,True
9263,193,48,84,35,121,85,37,50,True,True
9264,194,1,19,7,16,5,-3,-2,False,False
9265,194,2,17,8,14,10,-3,2,False,True
9266,194,3,13,5,10,16,-3,11,False,True
9267,194,4,2,6,6,10,4,4,True,True
9268,194,5,4,1,3,2,-1,1,False,True
9269,194,6,5,1,2,1,-3,0,False,False
9270,194,7,0,4,0,2,0,-2,False,False
9271,194,8,1,2,1,1,0,-1,False,False
9272,194,9,2,2,0,3,-2,1,False,True
9273,194,10,2,2,5,0,3,-2,True,False
9274,194,11,5,4,2,11,-3,7,False,True
9275,194,12,4,1,5,9,1,8,True,True
9276,194,13,5,8,6,13,1,5,True,True
9277,194,14,13,3,27,34,14,31,True,True
9278,194,15,17,7,12,51,-5,44,False,True
9279,194,16,12,6,44,57,32,51,True,True
9280,194,17,14,8,40,71,26,63,True,True
9281,194,18,16,5,69,111,53,106,True,True
9282,194,19,17,8,49,121,32,113,True,True
9283,194,20,16,13,41,114,25,101,True,True
9284,194,21,7,15,30,96,23,81,True,True
9285,194,22,14,22,30,102,16,80,True,True
9286,194,23,10,20,27,88,17,68,True,True
9287,194,24,8,18,24,89,16,71,True,True
9288,194,25,12,17,36,122,24,105,True,True
9289,194,26,23,15,58,134,35,119,True,True
9290,194,27,24,33,60,236,36,203,True,True
9291,194,28,16,22,56,292,40,270,True,True
9292,194,29,18,37,65,364,47,327,True,True
9293,194,30,23,26,98,452,75,426,True,True
9294,194,31,23,48,101,388,78,340,True,True
9295,194,32,35,33,141,322,106,289,True,True
9296,194,33,55,54,157,327,102,273,True,True
9297,194,34,62,67,140,312,78,245,True,True
9298,194,35,95,62,124,263,29,201,True,True
9299,194,36,100,78,142,231,42,153,True,True
9300,194,37,75,74,137,209,62,135,True,True
9301,194,38,70,87,131,178,61,91,True,True
9302,194,39,55,77,64,106,9,29,True,True
9303,194,40,53,40,71,67,18,27,True,True
9304,194,41,55,44,53,60,-2,16,False,True
9305,194,42,33,37,42,45,9,8,True,True
9306,194,43,35,24,28,32,-7,8,False,True
9307,194,44,19,15,17,16,-2,1,False,True
9308,194,45,13,17,15,10,2,-7,True,False
9309,194,46,12,13,16,8,4,-5,True,False
9310,194,47,12,9,7,7,-5,-2,False,False
9311,194,48,11,9,19,5,8,-4,True,False
9312,195,1,11,22,151,95,140,73,True,True
9313,195,2,6,28,152,124,146,96,True,True
9314,195,3,8,34,116,121,108,87,True,True
9315,195,4,7,16,86,85,79,69,True,True
9316,195,5,6,23,79,102,73,79,True,True
9317,195,6,2,11,68,77,66,66,True,True
9318,195,7,1,11,45,51,44,40,True,True
9319,195,8,1,5,55,59,54,54,True,True
9320,195,9,1,6,32,81,31,75,True,True
9321,195,10,5,5,28,51,23,46,True,True
9322,195,11,0,3,14,39,14,36,True,True
9323,195,12,2,1,15,16,13,15,True,True
9324,195,13,3,0,20,10,17,10,True,True
9325,195,14,4,15,22,15,18,0,True,False
9326,195,15,10,19,26,16,16,-3,True,False
9327,195,16,7,55,21,21,14,-34,True,False
9328,195,17,14,37,36,16,22,-21,True,False
9329,195,18,14,46,37,17,23,-29,True,False
9330,195,19,22,43,52,25,30,-18,True,False
9331,195,20,10,30,69,38,59,8,True,True
9332,195,21,9,49,63,58,54,9,True,True
9333,195,22,14,69,62,54,48,-15,True,False
9334,195,23,4,59,66,62,62,3,True,True
9335,195,24,10,21,57,101,47,80,True,True
9336,195,25,17,12,55,91,38,79,True,True
9337,195,26,11,11,63,102,52,91,True,True
9338,195,27,9,12,59,82,50,70,True,True
9339,195,28,10,20,63,103,53,83,True,True
9340,195,29,9,16,61,66,52,50,True,True
9341,195,30,10,24,66,97,56,73,True,True
9342,195,31,9,12,41,68,32,56,True,True
9343,195,32,7,13,50,71,43,58,True,True
9344,195,33,6,20,47,77,41,57,True,True
9345,195,34,9,14,62,53,53,39,True,True
9346,195,35,21,8,54,58,33,50,True,True
9347,195,36,30,17,91,70,61,53,True,True
9348,195,37,19,23,87,72,68,49,True,True
9349,195,38,17,15,112,69,95,54,True,True
9350,195,39,21,26,134,66,113,40,True,True
9351,195,40,25,20,129,76,104,56,True,True
9352,195,41,20,13,152,59,132,46,True,True
9353,195,42,15,23,101,49,86,26,True,True
9354,195,43,20,15,143,48,123,33,True,True
9355,195,44,25,27,130,68,105,41,True,True
9356,195,45,27,16,155,53,128,37,True,True
9357,195,46,23,7,134,53,111,46,True,True
9358,195,47,20,9,133,50,113,41,True,True
9359,195,48,14,12,166,69,152,57,True,True
9360,196,1,47,20,194,93,147,73,True,True
9361,196,2,49,27,180,121,131,94,True,True
9362,196,3,37,43,151,126,114,83,True,True
9363,196,4,16,36,104,139,88,103,True,True
9364,196,5,25,33,98,112,73,79,True,True
9365,196,6,14,22,72,115,58,93,True,True
9366,196,7,21,16,69,127,48,111,True,True
9367,196,8,15,20,50,118,35,98,True,True
9368,196,9,12,17,44,103,32,86,True,True
9369,196,10,8,11,34,76,26,65,True,True
9370,196,11,13,14,23,48,10,34,True,True
9371,196,12,40,14,28,35,-12,21,False,True
9372,196,13,46,24,18,30,-28,6,False,True
9373,196,14,69,22,27,19,-42,-3,False,False
9374,196,15,48,14,24,15,-24,1,False,True
9375,196,16,51,20,54,18,3,-2,True,False
9376,196,17,62,14,45,32,-17,18,False,True
9377,196,18,77,22,59,19,-18,-3,False,False
9378,196,19,40,28,26,36,-14,8,False,True
9379,196,20,27,37,34,18,7,-19,True,False
9380,196,21,12,22,36,18,24,-4,True,False
9381,196,22,11,27,47,32,36,5,True,True
9382,196,23,13,17,31,22,18,5,True,True
9383,196,24,11,13,36,16,25,3,True,True
9384,196,25,11,5,43,25,32,20,True,True
9385,196,26,8,7,42,19,34,12,True,True
9386,196,27,14,8,32,23,18,15,True,True
9387,196,28,10,11,41,27,31,16,True,True
9388,196,29,17,15,57,16,40,1,True,True
9389,196,30,11,8,44,15,33,7,True,True
9390,196,31,13,12,45,28,32,16,True,True
9391,196,32,11,13,54,13,43,0,True,False
9392,196,33,11,14,39,12,28,-2,True,False
9393,196,34,14,9,46,25,32,16,True,True
9394,196,35,12,6,47,22,35,16,True,True
9395,196,36,6,3,31,33,25,30,True,True
9396,196,37,8,9,56,34,48,25,True,True
9397,196,38,10,13,78,25,68,12,True,True
9398,196,39,11,6,65,38,54,32,True,True
9399,196,40,14,7,85,33,71,26,True,True
9400,196,41,15,9,99,28,84,19,True,True
9401,196,42,21,4,120,28,99,24,True,True
9402,196,43,22,11,158,41,136,30,True,True
9403,196,44,23,11,158,43,135,32,True,True
9404,196,45,22,15,183,40,161,25,True,True
9405,196,46,33,9,199,49,166,40,True,True
9406,196,47,28,16,229,67,201,51,True,True
9407,196,48,39,23,250,73,211,50,True,True
9408,197,1,9,1,81,36,72,35,True,True
9409,197,2,8,2,68,42,60,40,True,True
9410,197,3,6,1,69,50,63,49,True,True
9411,197,4,4,2,54,33,50,31,True,True
9412,197,5,4,3,39,32,35,29,True,True
9413,197,6,1,4,21,31,20,27,True,True
9414,197,7,1,5,13,34,12,29,True,True
9415,197,8,6,6,14,25,8,19,True,True
9416,197,9,6,6,17,37,11,31,True,True
9417,197,10,6,4,14,23,8,19,True,True
9418,197,11,10,7,14,22,4,15,True,True
9419,197,12,12,2,18,19,6,17,True,True
9420,197,13,15,5,11,5,-4,0,False,False
9421,197,14,17,1,28,7,11,6,True,True
9422,197,15,17,3,32,23,15,20,True,True
9423,197,16,9,3,25,12,16,9,True,True
9424,197,17,8,3,26,12,18,9,True,True
9425,197,18,5,0,22,13,17,13,True,True
9426,197,19,6,2,24,14,18,12,True,True
9427,197,20,10,2,26,15,16,13,True,True
9428,197,21,8,7,32,11,24,4,True,True
9429,197,22,6,2,38,8,32,6,True,True
9430,197,23,5,4,20,8,15,4,True,True
9431,197,24,5,5,14,15,9,10,True,True
9432,197,25,7,6,24,12,17,6,True,True
9433,197,26,2,7,14,11,12,4,True,True
9434,197,27,5,3,20,7,15,4,True,True
9435,197,28,5,5,18,12,13,7,True,True
9436,197,29,2,7,24,18,22,11,True,True
9437,197,30,9,4,29,12,20,8,True,True
9438,197,31,9,3,38,13,29,10,True,True
9439,197,32,6,5,48,23,42,18,True,True
9440,197,33,7,6,39,20,32,14,True,True
9441,197,34,14,6,36,17,22,11,True,True
9442,197,35,10,6,27,16,17,10,True,True
9443,197,36,6,5,24,19,18,14,True,True
9444,197,37,4,1,34,23,30,22,True,True
9445,197,38,6,2,42,23,36,21,True,True
9446,197,39,9,4,43,21,34,17,True,True
9447,197,40,4,3,36,17,32,14,True,True
9448,197,41,2,2,50,13,48,11,True,True
9449,197,42,6,2,35,17,29,15,True,True
9450,197,43,11,4,42,15,31,11,True,True
9451,197,44,2,3,50,20,48,17,True,True
9452,197,45,2,2,60,14,58,12,True,True
9453,197,46,2,7,64,31,62,24,True,True
9454,197,47,3,7,71,31,68,24,True,True
9455,197,48,4,1,93,33,89,32,True,True
9456,198,1,11,7,281,109,270,102,True,True
9457,198,2,11,10,265,154,254,144,True,True
9458,198,3,10,16,255,197,245,181,True,True
9459,198,4,8,10,236,208,228,198,True,True
9460,198,5,10,13,185,202,175,189,True,True
9461,198,6,4,19,180,203,176,184,True,True
9462,198,7,9,28,134,218,125,190,True,True
9463,198,8,8,15,126,181,118,166,True,True
9464,198,9,4,20,111,199,107,179,True,True
9465,198,10,6,24,99,188,93,164,True,True
9466,198,11,7,11,65,108,58,97,True,True
9467,198,12,6,8,45,68,39,60,True,True
9468,198,13,5,4,30,35,25,31,True,True
9469,198,14,5,2,20,20,15,18,True,True
9470,198,15,5,1,21,24,16,23,True,True
9471,198,16,1,1,20,19,19,18,True,True
9472,198,17,1,3,17,20,16,17,True,True
9473,198,18,2,2,29,18,27,16,True,True
9474,198,19,2,1,22,7,20,6,True,True
9475,198,20,1,0,20,23,19,23,True,True
9476,198,21,0,4,27,9,27,5,True,True
9477,198,22,2,0,19,13,17,13,True,True
9478,198,23,3,1,18,14,15,13,True,True
9479,198,24,0,4,23,17,23,13,True,True
9480,198,25,0,1,18,15,18,14,True,True
9481,198,26,1,2,28,15,27,13,True,True
9482,198,27,1,2,23,21,22,19,True,True
9483,198,28,3,0,34,13,31,13,True,True
9484,198,29,0,4,31,26,31,22,True,True
9485,198,30,0,2,36,27,36,25,True,True
9486,198,31,4,1,39,21,35,20,True,True
9487,198,32,2,3,33,22,31,19,True,True
9488,198,33,1,2,31,26,30,24,True,True
9489,198,34,2,0,36,30,34,30,True,True
9490,198,35,1,0,25,18,24,18,True,True
9491,198,36,0,0,40,33,40,33,True,True
9492,198,37,2,5,53,29,51,24,True,True
9493,198,38,3,2,67,32,64,30,True,True
9494,198,39,1,1,51,36,50,35,True,True
9495,198,40,3,1,55,34,52,33,True,True
9496,198,41,3,3,52,39,49,36,True,True
9497,198,42,8,1,79,40,71,39,True,True
9498,198,43,6,2,100,42,94,40,True,True
9499,198,44,2,9,141,53,139,44,True,True
9500,198,45,7,5,148,59,141,54,True,True
9501,198,46,8,4,164,61,156,57,True,True
9502,198,47,7,13,187,96,180,83,True,True
9503,198,48,7,9,242,106,235,97,True,True
9504,199,1,1,0,0,0,-1,0,False,False
9505,199,2,0,0,0,0,0,0,False,False
9506,199,3,0,0,0,0,0,0,False,False
9507,199,4,0,0,0,0,0,0,False,False
9508,199,5,0,0,0,0,0,0,False,False
9509,199,6,0,0,1,0,1,0,True,False
9510,199,7,0,0,0,0,0,0,False,False
9511,199,8,0,0,0,0,0,0,False,False
9512,199,9,0,0,0,0,0,0,False,False
9513,199,10,0,0,0,0,0,0,False,False
9514,199,11,0,0,0,0,0,0,False,False
9515,199,12,0,0,0,0,0,0,False,False
9516,199,13,0,0,0,0,0,0,False,False
9517,199,14,0,0,0,0,0,0,False,False
9518,199,15,0,0,1,0,1,0,True,False
9519,199,16,0,0,0,0,0,0,False,False
9520,199,17,1,0,0,0,-1,0,False,False
9521,199,18,0,0,1,1,1,1,True,True
9522,199,19,0,1,1,0,1,-1,True,False
9523,199,20,0,1,0,1,0,0,False,False
9524,199,21,0,0,0,1,0,1,False,True
9525,199,22,0,0,0,0,0,0,False,False
9526,199,23,0,0,0,0,0,0,False,False
9527,199,24,0,1,0,0,0,-1,False,False
9528,199,25,0,0,0,0,0,0,False,False
9529,199,26,0,0,0,0,0,0,False,False
9530,199,27,0,0,0,0,0,0,False,False
9531,199,28,0,0,0,0,0,0,False,False
9532,199,29,0,0,0,0,0,0,False,False
9533,199,30,0,0,0,0,0,0,False,False
9534,199,31,0,0,0,0,0,0,False,False
9535,199,32,0,0,0,0,0,0,False,False
9536,199,33,0,1,1,0,1,-1,True,False
9537,199,34,2,2,3,2,1,0,True,False
9538,199,35,3,1,2,2,-1,1,False,True
9539,199,36,0,2,1,1,1,-1,True,False
9540,199,37,0,0,0,0,0,0,False,False
9541,199,38,1,0,0,0,-1,0,False,False
9542,199,39,0,0,1,0,1,0,True,False
9543,199,40,0,0,0,0,0,0,False,False
9544,199,41,2,0,0,0,-2,0,False,False
9545,199,42,0,0,1,0,1,0,True,False
9546,199,43,1,0,1,0,0,0,False,False
9547,199,44,0,1,1,0,1,-1,True,False
9548,199,45,0,1,0,2,0,1,False,True
9549,199,46,0,0,0,0,0,0,False,False
9550,199,47,0,0,0,0,0,0,False,False
9551,199,48,0,0,0,0,0,0,False,False
9552,200,1,2,2,103,58,101,56,True,True
9553,200,2,2,0,88,71,86,71,True,True
9554,200,3,1,0,65,60,64,60,True,True
9555,200,4,2,0,62,72,60,72,True,True
9556,200,5,1,1,54,58,53,57,True,True
9557,200,6,0,3,41,58,41,55,True,True
9558,200,7,0,0,22,62,22,62,True,True
9559,200,8,0,6,23,56,23,50,True,True
9560,200,9,0,1,17,35,17,34,True,True
9561,200,10,1,0,13,18,12,18,True,True
9562,200,11,3,1,7,24,4,23,True,True
9563,200,12,0,1,9,15,9,14,True,True
9564,200,13,0,0,5,5,5,5,True,True
9565,200,14,0,0,12,7,12,7,True,True
9566,200,15,0,1,19,10,19,9,True,True
9567,200,16,2,0,22,27,20,27,True,True
9568,200,17,0,0,41,16,41,16,True,True
9569,200,18,1,2,65,14,64,12,True,True
9570,200,19,2,1,62,17,60,16,True,True
9571,200,20,1,0,59,16,58,16,True,True
9572,200,21,3,2,47,11,44,9,True,True
9573,200,22,1,1,46,26,45,25,True,True
9574,200,23,1,0,46,23,45,23,True,True
9575,200,24,3,1,37,17,34,16,True,True
9576,200,25,1,0,47,21,46,21,True,True
9577,200,26,1,1,28,20,27,19,True,True
9578,200,27,0,1,37,20,37,19,True,True
9579,200,28,1,0,63,25,62,25,True,True
9580,200,29,5,1,37,25,32,24,True,True
9581,200,30,1,0,45,27,44,27,True,True
9582,200,31,0,1,48,13,48,12,True,True
9583,200,32,1,0,46,27,45,27,True,True
9584,200,33,2,0,51,32,49,32,True,True
9585,200,34,1,1,27,32,26,31,True,True
9586,200,35,2,0,21,18,19,18,True,True
9587,200,36,1,3,31,36,30,33,True,True
9588,200,37,2,2,51,23,49,21,True,True
9589,200,38,2,0,77,33,75,33,True,True
9590,200,39,3,0,85,36,82,36,True,True
9591,200,40,3,0,100,17,97,17,True,True
9592,200,41,4,0,136,17,132,17,True,True
9593,200,42,3,1,131,32,128,31,True,True
9594,200,43,0,0,125,34,125,34,True,True
9595,200,44,1,0,154,30,153,30,True,True
9596,200,45,3,0,165,37,162,37,True,True
9597,200,46,5,0,144,31,139,31,True,True
9598,200,47,2,2,168,39,166,37,True,True
9599,200,48,0,0,159,47,159,47,True,True
9600,201,1,0,0,11,3,11,3,True,True
9601,201,2,1,1,11,5,10,4,True,True
9602,201,3,0,0,12,8,12,8,True,True
9603,201,4,0,1,10,12,10,11,True,True
9604,201,5,0,2,4,7,4,5,True,True
9605,201,6,0,0,5,3,5,3,True,True
9606,201,7,0,0,2,3,2,3,True,True
9607,201,8,1,1,1,8,0,7,False,True
9608,201,9,0,0,1,2,1,2,True,True
9609,201,10,0,0,0,5,0,5,False,True
9610,201,11,0,0,2,5,2,5,True,True
9611,201,12,0,0,4,0,4,0,True,False
9612,201,13,0,0,2,3,2,3,True,True
9613,201,14,0,0,2,1,2,1,True,True
9614,201,15,0,0,0,0,0,0,False,False
9615,201,16,0,0,2,2,2,2,True,True
9616,201,17,0,0,0,1,0,1,False,True
9617,201,18,0,0,2,1,2,1,True,True
9618,201,19,0,0,2,3,2,3,True,True
9619,201,20,0,0,2,3,2,3,True,True
9620,201,21,0,0,0,4,0,4,False,True
9621,201,22,0,0,2,2,2,2,True,True
9622,201,23,0,0,0,1,0,1,False,True
9623,201,24,0,0,4,1,4,1,True,True
9624,201,25,0,0,3,0,3,0,True,False
9625,201,26,0,0,2,3,2,3,True,True
9626,201,27,0,0,0,3,0,3,False,True
9627,201,28,0,0,5,4,5,4,True,True
9628,201,29,0,0,4,3,4,3,True,True
9629,201,30,0,0,4,4,4,4,True,True
9630,201,31,0,0,3,3,3,3,True,True
9631,201,32,0,0,4,3,4,3,True,True
9632,201,33,0,0,5,2,5,2,True,True
9633,201,34,0,0,3,4,3,4,True,True
9634,201,35,0,0,6,0,6,0,True,False
9635,201,36,0,1,0,3,0,2,False,True
9636,201,37,0,0,2,3,2,3,True,True
9637,201,38,0,0,2,4,2,4,True,True
9638,201,39,0,0,7,3,7,3,True,True
9639,201,40,0,0,9,3,9,3,True,True
9640,201,41,0,1,2,7,2,6,True,True
9641,201,42,0,0,5,3,5,3,True,True
9642,201,43,1,0,15,4,14,4,True,True
9643,201,44,0,0,7,2,7,2,True,True
9644,201,45,0,0,7,2,7,2,True,True
9645,201,46,0,0,15,6,15,6,True,True
9646,201,47,0,0,14,3,14,3,True,True
9647,201,48,0,0,12,2,12,2,True,True
9648,202,1,23,27,235,130,212,103,True,True
9649,202,2,21,25,203,151,182,126,True,True
9650,202,3,14,15,146,122,132,107,True,True
9651,202,4,7,11,137,145,130,134,True,True
9652,202,5,14,13,129,144,115,131,True,True
9653,202,6,7,6,96,105,89,99,True,True
9654,202,7,4,11,72,108,68,97,True,True
9655,202,8,6,7,61,117,55,110,True,True
9656,202,9,7,6,56,134,49,128,True,True
9657,202,10,4,4,37,100,33,96,True,True
9658,202,11,5,6,28,67,23,61,True,True
9659,202,12,6,5,22,37,16,32,True,True
9660,202,13,3,6,11,28,8,22,True,True
9661,202,14,8,1,17,22,9,21,True,True
9662,202,15,8,5,17,13,9,8,True,True
9663,202,16,13,7,41,17,28,10,True,True
9664,202,17,15,6,32,22,17,16,True,True
9665,202,18,10,11,15,25,5,14,True,True
9666,202,19,9,16,23,38,14,22,True,True
9667,202,20,12,10,32,24,20,14,True,True
9668,202,21,6,9,21,30,15,21,True,True
9669,202,22,9,13,30,26,21,13,True,True
9670,202,23,12,16,26,30,14,14,True,True
9671,202,24,13,18,38,37,25,19,True,True
9672,202,25,11,13,36,45,25,32,True,True
9673,202,26,18,11,61,60,43,49,True,True
9674,202,27,15,14,60,46,45,32,True,True
9675,202,28,9,11,64,47,55,36,True,True
9676,202,29,18,11,51,46,33,35,True,True
9677,202,30,12,14,77,42,65,28,True,True
9678,202,31,13,20,59,55,46,35,True,True
9679,202,32,7,15,62,46,55,31,True,True
9680,202,33,9,16,53,55,44,39,True,True
9681,202,34,10,14,57,48,47,34,True,True
9682,202,35,18,18,64,51,46,33,True,True
9683,202,36,14,24,87,53,73,29,True,True
9684,202,37,27,11,111,58,84,47,True,True
9685,202,38,23,13,137,54,114,41,True,True
9686,202,39,30,16,160,57,130,41,True,True
9687,202,40,37,22,185,67,148,45,True,True
9688,202,41,32,18,180,72,148,54,True,True
9689,202,42,23,18,183,81,160,63,True,True
9690,202,43,38,28,241,74,203,46,True,True
9691,202,44,42,28,232,103,190,75,True,True
9692,202,45,34,21,277,89,243,68,True,True
9693,202,46,39,23,263,99,224,76,True,True
9694,202,47,31,19,252,107,221,88,True,True
9695,202,48,28,18,289,130,261,112,True,True
9696,203,1,1,1,16,4,15,3,True,True
9697,203,2,0,0,20,5,20,5,True,True
9698,203,3,3,0,15,4,12,4,True,True
9699,203,4,2,0,14,2,12,2,True,True
9700,203,5,0,0,10,3,10,3,True,True
9701,203,6,0,0,4,2,4,2,True,True
9702,203,7,1,0,3,4,2,4,True,True
9703,203,8,1,0,1,3,0,3,False,True
9704,203,9,1,0,4,2,3,2,True,True
9705,203,10,1,0,0,5,-1,5,False,True
9706,203,11,0,0,2,5,2,5,True,True
9707,203,12,1,0,7,3,6,3,True,True
9708,203,13,1,0,6,3,5,3,True,True
9709,203,14,1,0,4,1,3,1,True,True
9710,203,15,6,0,6,5,0,5,False,True
9711,203,16,0,0,9,6,9,6,True,True
9712,203,17,1,0,4,3,3,3,True,True
9713,203,18,1,0,19,8,18,8,True,True
9714,203,19,1,0,15,10,14,10,True,True
9715,203,20,1,0,9,4,8,4,True,True
9716,203,21,2,0,11,5,9,5,True,True
9717,203,22,0,1,11,3,11,2,True,True
9718,203,23,1,0,8,4,7,4,True,True
9719,203,24,1,0,9,6,8,6,True,True
9720,203,25,2,0,12,2,10,2,True,True
9721,203,26,0,0,10,3,10,3,True,True
9722,203,27,3,1,15,4,12,3,True,True
9723,203,28,0,0,7,4,7,4,True,True
9724,203,29,1,0,14,5,13,5,True,True
9725,203,30,4,1,16,4,12,3,True,True
9726,203,31,1,0,14,7,13,7,True,True
9727,203,32,1,0,9,7,8,7,True,True
9728,203,33,0,0,12,2,12,2,True,True
9729,203,34,1,0,12,4,11,4,True,True
9730,203,35,0,0,7,4,7,4,True,True
9731,203,36,1,0,8,5,7,5,True,True
9732,203,37,0,0,11,2,11,2,True,True
9733,203,38,0,0,11,5,11,5,True,True
9734,203,39,0,0,10,4,10,4,True,True
9735,203,40,2,0,10,5,8,5,True,True
9736,203,41,0,0,10,7,10,7,True,True
9737,203,42,0,0,14,3,14,3,True,True
9738,203,43,1,0,14,5,13,5,True,True
9739,203,44,0,0,13,2,13,2,True,True
9740,203,45,0,0,12,2,12,2,True,True
9741,203,46,0,0,12,4,12,4,True,True
9742,203,47,2,0,10,4,8,4,True,True
9743,203,48,0,0,19,6,19,6,True,True
9744,204,1,0,0,2,1,2,1,True,True
9745,204,2,2,0,4,2,2,2,True,True
9746,204,3,0,0,3,3,3,3,True,True
9747,204,4,0,0,1,1,1,1,True,True
9748,204,5,0,0,1,1,1,1,True,True
9749,204,6,0,0,0,0,0,0,False,False
9750,204,7,0,0,2,1,2,1,True,True
9751,204,8,0,0,0,0,0,0,False,False
9752,204,9,0,0,2,0,2,0,True,False
9753,204,10,0,0,0,1,0,1,False,True
9754,204,11,0,0,0,1,0,1,False,True
9755,204,12,0,0,0,0,0,0,False,False
9756,204,13,0,0,0,0,0,0,False,False
9757,204,14,0,0,0,0,0,0,False,False
9758,204,15,0,0,0,0,0,0,False,False
9759,204,16,0,0,1,0,1,0,True,False
9760,204,17,1,0,2,0,1,0,True,False
9761,204,18,0,0,0,0,0,0,False,False
9762,204,19,0,0,0,0,0,0,False,False
9763,204,20,0,0,0,1,0,1,False,True
9764,204,21,0,0,0,0,0,0,False,False
9765,204,22,0,0,0,0,0,0,False,False
9766,204,23,0,0,1,0,1,0,True,False
9767,204,24,0,0,0,0,0,0,False,False
9768,204,25,0,0,1,1,1,1,True,True
9769,204,26,0,0,1,0,1,0,True,False
9770,204,27,0,0,0,0,0,0,False,False
9771,204,28,0,0,1,0,1,0,True,False
9772,204,29,0,0,1,0,1,0,True,False
9773,204,30,0,0,0,0,0,0,False,False
9774,204,31,0,0,0,0,0,0,False,False
9775,204,32,0,0,0,0,0,0,False,False
9776,204,33,0,0,0,0,0,0,False,False
9777,204,34,0,0,0,3,0,3,False,True
9778,204,35,0,0,0,1,0,1,False,True
9779,204,36,0,0,0,0,0,0,False,False
9780,204,37,0,0,0,1,0,1,False,True
9781,204,38,0,0,1,0,1,0,True,False
9782,204,39,0,0,0,0,0,0,False,False
9783,204,40,0,0,0,1,0,1,False,True
9784,204,41,0,0,1,0,1,0,True,False
9785,204,42,0,0,5,1,5,1,True,True
9786,204,43,0,0,2,1,2,1,True,True
9787,204,44,1,0,1,0,0,0,False,False
9788,204,45,1,0,2,0,1,0,True,False
9789,204,46,0,0,3,0,3,0,True,False
9790,204,47,0,0,1,0,1,0,True,False
9791,204,48,0,0,4,0,4,0,True,False
9792,205,1,3,0,26,14,23,14,True,True
9793,205,2,1,0,34,13,33,13,True,True
9794,205,3,2,1,40,17,38,16,True,True
9795,205,4,0,1,11,12,11,11,True,True
9796,205,5,1,0,20,6,19,6,True,True
9797,205,6,1,0,14,13,13,13,True,True
9798,205,7,0,2,8,7,8,5,True,True
9799,205,8,0,0,5,4,5,4,True,True
9800,205,9,1,1,5,5,4,4,True,True
9801,205,10,0,0,1,6,1,6,True,True
9802,205,11,0,0,5,7,5,7,True,True
9803,205,12,0,0,5,2,5,2,True,True
9804,205,13,1,0,9,4,8,4,True,True
9805,205,14,6,0,10,8,4,8,True,True
9806,205,15,5,0,10,4,5,4,True,True
9807,205,16,0,0,6,2,6,2,True,True
9808,205,17,0,0,8,4,8,4,True,True
9809,205,18,0,0,9,3,9,3,True,True
9810,205,19,2,0,12,6,10,6,True,True
9811,205,20,0,1,11,7,11,6,True,True
9812,205,21,2,0,10,1,8,1,True,True
9813,205,22,0,0,18,10,18,10,True,True
9814,205,23,0,0,9,6,9,6,True,True
9815,205,24,0,1,15,5,15,4,True,True
9816,205,25,1,0,10,5,9,5,True,True
9817,205,26,1,0,13,8,12,8,True,True
9818,205,27,0,0,10,1,10,1,True,True
9819,205,28,0,1,15,8,15,7,True,True
9820,205,29,0,0,11,8,11,8,True,True
9821,205,30,0,0,10,9,10,9,True,True
9822,205,31,0,0,12,7,12,7,True,True
9823,205,32,0,1,14,10,14,9,True,True
9824,205,33,0,2,17,9,17,7,True,True
9825,205,34,0,2,23,12,23,10,True,True
9826,205,35,0,0,15,11,15,11,True,True
9827,205,36,1,0,15,7,14,7,True,True
9828,205,37,0,1,16,3,16,2,True,True
9829,205,38,0,0,10,12,10,12,True,True
9830,205,39,0,0,22,9,22,9,True,True
9831,205,40,0,1,13,18,13,17,True,True
9832,205,41,2,0,20,14,18,14,True,True
9833,205,42,2,0,21,7,19,7,True,True
9834,205,43,0,0,17,8,17,8,True,True
9835,205,44,0,0,18,13,18,13,True,True
9836,205,45,1,0,18,12,17,12,True,True
9837,205,46,0,0,29,14,29,14,True,True
9838,205,47,1,0,23,14,22,14,True,True
9839,205,48,0,1,16,11,16,10,True,True
9840,206,1,0,0,9,3,9,3,True,True
9841,206,2,0,0,3,4,3,4,True,True
9842,206,3,0,0,2,4,2,4,True,True
9843,206,4,0,0,7,8,7,8,True,True
9844,206,5,0,0,5,5,5,5,True,True
9845,206,6,0,0,2,3,2,3,True,True
9846,206,7,0,0,1,2,1,2,True,True
9847,206,8,0,0,2,3,2,3,True,True
9848,206,9,0,1,1,4,1,3,True,True
9849,206,10,0,0,1,2,1,2,True,True
9850,206,11,0,1,4,2,4,1,True,True
9851,206,12,0,0,1,2,1,2,True,True
9852,206,13,0,0,0,0,0,0,False,False
9853,206,14,1,0,0,1,-1,1,False,True
9854,206,15,0,0,1,0,1,0,True,False
9855,206,16,0,0,2,1,2,1,True,True
9856,206,17,3,0,2,3,-1,3,False,True
9857,206,18,0,0,3,2,3,2,True,True
9858,206,19,0,0,0,2,0,2,False,True
9859,206,20,0,0,0,0,0,0,False,False
9860,206,21,0,0,4,0,4,0,True,False
9861,206,22,0,0,4,1,4,1,True,True
9862,206,23,1,0,2,2,1,2,True,True
9863,206,24,3,0,4,3,1,3,True,True
9864,206,25,2,0,3,0,1,0,True,False
9865,206,26,4,0,4,1,0,1,False,True
9866,206,27,0,0,1,4,1,4,True,True
9867,206,28,0,0,0,1,0,1,False,True
9868,206,29,0,0,5,1,5,1,True,True
9869,206,30,1,0,0,0,-1,0,False,False
9870,206,31,0,0,3,3,3,3,True,True
9871,206,32,0,0,4,3,4,3,True,True
9872,206,33,0,0,0,3,0,3,False,True
9873,206,34,0,0,1,0,1,0,True,False
9874,206,35,0,0,3,2,3,2,True,True
9875,206,36,0,0,2,0,2,0,True,False
9876,206,37,0,1,3,2,3,1,True,True
9877,206,38,0,0,2,4,2,4,True,True
9878,206,39,0,0,3,4,3,4,True,True
9879,206,40,0,0,4,0,4,0,True,False
9880,206,41,0,0,3,4,3,4,True,True
9881,206,42,0,0,1,2,1,2,True,True
9882,206,43,0,0,6,2,6,2,True,True
9883,206,44,0,0,6,1,6,1,True,True
9884,206,45,0,0,12,3,12,3,True,True
9885,206,46,0,0,7,2,7,2,True,True
9886,206,47,0,0,11,3,11,3,True,True
9887,206,48,0,0,4,6,4,6,True,True
9888,207,1,4,1,5,6,1,5,True,True
9889,207,2,1,2,4,3,3,1,True,True
9890,207,3,5,0,4,3,-1,3,False,True
9891,207,4,1,7,7,6,6,-1,True,False
9892,207,5,0,5,3,5,3,0,True,False
9893,207,6,1,5,1,4,0,-1,False,False
9894,207,7,1,0,1,1,0,1,False,True
9895,207,8,2,1,2,3,0,2,False,True
9896,207,9,2,3,6,9,4,6,True,True
9897,207,10,2,1,3,2,1,1,True,True
9898,207,11,5,1,5,0,0,-1,False,False
9899,207,12,41,2,32,0,-9,-2,False,False
9900,207,13,119,0,100,2,-19,2,False,True
9901,207,14,96,2,104,1,8,-1,True,False
9902,207,15,102,0,97,2,-5,2,False,True
9903,207,16,102,1,103,2,1,1,True,True
9904,207,17,85,2,87,1,2,-1,True,False
9905,207,18,79,5,77,4,-2,-1,False,False
9906,207,19,70,1,70,3,0,2,False,True
9907,207,20,58,1,50,3,-8,2,False,True
9908,207,21,52,2,56,2,4,0,True,False
9909,207,22,59,0,55,2,-4,2,False,True
9910,207,23,55,0,50,3,-5,3,False,True
9911,207,24,60,1,51,3,-9,2,False,True
9912,207,25,31,1,37,0,6,-1,True,False
9913,207,26,18,0,17,3,-1,3,False,True
9914,207,27,25,0,26,1,1,1,True,True
9915,207,28,25,3,20,5,-5,2,False,True
9916,207,29,32,0,31,0,-1,0,False,False
9917,207,30,34,0,39,1,5,1,True,True
9918,207,31,23,1,25,1,2,0,True,False
9919,207,32,26,3,25,1,-1,-2,False,False
9920,207,33,9,1,13,2,4,1,True,True
9921,207,34,8,2,2,1,-6,-1,False,False
9922,207,35,1,2,3,1,2,-1,True,False
9923,207,36,7,3,5,1,-2,-2,False,False
9924,207,37,7,2,4,2,-3,0,False,False
9925,207,38,7,1,7,2,0,1,False,True
9926,207,39,2,0,4,5,2,5,True,True
9927,207,40,5,3,4,2,-1,-1,False,False
9928,207,41,6,2,1,1,-5,-1,False,False
9929,207,42,3,0,5,0,2,0,True,False
9930,207,43,4,0,7,1,3,1,True,True
9931,207,44,3,0,4,2,1,2,True,True
9932,207,45,4,1,3,4,-1,3,False,True
9933,207,46,1,2,4,4,3,2,True,True
9934,207,47,6,0,6,7,0,7,False,True
9935,207,48,4,0,6,5,2,5,True,True
9936,208,1,2,1,32,22,30,21,True,True
9937,208,2,2,1,43,33,41,32,True,True
9938,208,3,1,1,31,28,30,27,True,True
9939,208,4,1,0,27,31,26,31,True,True
9940,208,5,0,1,21,37,21,36,True,True
9941,208,6,2,1,27,36,25,35,True,True
9942,208,7,0,3,14,32,14,29,True,True
9943,208,8,1,0,13,31,12,31,True,True
9944,208,9,0,1,18,40,18,39,True,True
9945,208,10,1,2,14,26,13,24,True,True
9946,208,11,0,2,6,22,6,20,True,True
9947,208,12,0,0,4,11,4,11,True,True
9948,208,13,1,1,6,6,5,5,True,True
9949,208,14,0,0,7,7,7,7,True,True
9950,208,15,0,0,7,7,7,7,True,True
9951,208,16,0,0,3,5,3,5,True,True
9952,208,17,0,0,8,8,8,8,True,True
9953,208,18,2,0,12,10,10,10,True,True
9954,208,19,2,1,11,2,9,1,True,True
9955,208,20,2,1,9,5,7,4,True,True
9956,208,21,2,2,12,10,10,8,True,True
9957,208,22,1,3,12,11,11,8,True,True
9958,208,23,2,2,9,9,7,7,True,True
9959,208,24,2,1,11,4,9,3,True,True
9960,208,25,3,2,7,7,4,5,True,True
9961,208,26,0,1,11,9,11,8,True,True
9962,208,27,0,2,7,9,7,7,True,True
9963,208,28,0,3,6,11,6,8,True,True
9964,208,29,0,2,9,9,9,7,True,True
9965,208,30,0,3,12,10,12,7,True,True
9966,208,31,0,3,17,9,17,6,True,True
9967,208,32,1,0,8,9,7,9,True,True
9968,208,33,0,1,13,8,13,7,True,True
9969,208,34,0,1,11,9,11,8,True,True
9970,208,35,0,0,14,7,14,7,True,True
9971,208,36,1,0,12,10,11,10,True,True
9972,208,37,1,0,26,5,25,5,True,True
9973,208,38,0,0,19,15,19,15,True,True
9974,208,39,0,0,30,4,30,4,True,True
9975,208,40,0,0,22,9,22,9,True,True
9976,208,41,1,0,36,14,35,14,True,True
9977,208,42,3,0,36,13,33,13,True,True
9978,208,43,1,0,29,11,28,11,True,True
9979,208,44,2,1,58,10,56,9,True,True
9980,208,45,2,1,51,17,49,16,True,True
9981,208,46,1,0,46,8,45,8,True,True
9982,208,47,2,1,58,13,56,12,True,True
9983,208,48,2,2,38,18,36,16,True,True
9984,209,1,353,462,608,443,255,-19,True,False
9985,209,2,275,509,529,497,254,-12,True,False
9986,209,3,149,492,387,462,238,-30,True,False
9987,209,4,115,458,271,450,156,-8,True,False
9988,209,5,102,442,235,403,133,-39,True,False
9989,209,6,71,388,160,399,89,11,True,True
9990,209,7,46,302,146,417,100,115,True,True
9991,209,8,58,151,97,304,39,153,True,True
9992,209,9,55,125,96,244,41,119,True,True
9993,209,10,61,55,56,146,-5,91,False,True
9994,209,11,48,47,43,78,-5,31,False,True
9995,209,12,69,36,80,49,11,13,True,True
9996,209,13,93,49,102,39,9,-10,True,False
9997,209,14,217,32,272,51,55,19,True,True
9998,209,15,239,62,471,38,232,-24,True,False
9999,209,16,355,73,493,65,138,-8,True,False
10000,209,17,402,87,568,76,166,-11,True,False
10001,209,18,413,99,843,98,430,-1,True,False
10002,209,19,443,105,654,135,211,30,True,True
10003,209,20,383,151,683,155,300,4,True,True
10004,209,21,384,174,602,185,218,11,True,True
10005,209,22,386,198,590,216,204,18,True,True
10006,209,23,410,220,520,283,110,63,True,True
10007,209,24,387,273,529,302,142,29,True,True
10008,209,25,395,226,522,311,127,85,True,True
10009,209,26,357,274,503,297,146,23,True,True
10010,209,27,376,242,462,322,86,80,True,True
10011,209,28,416,283,460,352,44,69,True,True
10012,209,29,389,301,459,421,70,120,True,True
10013,209,30,349,303,491,460,142,157,True,True
10014,209,31,380,297,460,421,80,124,True,True
10015,209,32,307,320,391,456,84,136,True,True
10016,209,33,281,353,348,423,67,70,True,True
10017,209,34,261,331,282,376,21,45,True,True
10018,209,35,329,388,311,376,-18,-12,False,False
10019,209,36,403,433,411,362,8,-71,True,False
10020,209,37,506,466,495,448,-11,-18,False,False
10021,209,38,489,444,533,420,44,-24,True,False
10022,209,39,522,464,628,404,106,-60,True,False
10023,209,40,563,445,622,378,59,-67,True,False
10024,209,41,571,432,689,346,118,-86,True,False
10025,209,42,692,408,758,389,66,-19,True,False
10026,209,43,789,430,815,359,26,-71,True,False
10027,209,44,790,367,845,346,55,-21,True,False
10028,209,45,752,418,889,440,137,22,True,True
10029,209,46,706,348,914,442,208,94,True,True
10030,209,47,566,340,835,413,269,73,True,True
10031,209,48,499,315,736,382,237,67,True,True
10032,210,1,0,0,56,18,56,18,True,True
10033,210,2,1,2,41,32,40,30,True,True
10034,210,3,1,1,40,28,39,27,True,True
10035,210,4,1,2,37,23,36,21,True,True
10036,210,5,2,0,27,20,25,20,True,True
10037,210,6,1,0,23,26,22,26,True,True
10038,210,7,1,0,14,20,13,20,True,True
10039,210,8,0,2,9,26,9,24,True,True
10040,210,9,0,1,6,30,6,29,True,True
10041,210,10,0,1,7,19,7,18,True,True
10042,210,11,1,4,6,14,5,10,True,True
10043,210,12,0,1,7,7,7,6,True,True
10044,210,13,1,0,10,8,9,8,True,True
10045,210,14,0,2,9,6,9,4,True,True
10046,210,15,1,1,9,4,8,3,True,True
10047,210,16,1,1,4,3,3,2,True,True
10048,210,17,3,1,16,7,13,6,True,True
10049,210,18,2,3,8,6,6,3,True,True
10050,210,19,1,1,13,2,12,1,True,True
10051,210,20,1,1,7,4,6,3,True,True
10052,210,21,1,1,9,4,8,3,True,True
10053,210,22,1,1,11,8,10,7,True,True
10054,210,23,0,3,12,7,12,4,True,True
10055,210,24,3,2,18,7,15,5,True,True
10056,210,25,1,2,12,3,11,1,True,True
10057,210,26,0,2,10,5,10,3,True,True
10058,210,27,2,3,9,8,7,5,True,True
10059,210,28,0,2,15,8,15,6,True,True
10060,210,29,2,2,19,9,17,7,True,True
10061,210,30,1,0,20,10,19,10,True,True
10062,210,31,3,3,18,14,15,11,True,True
10063,210,32,0,2,6,13,6,11,True,True
10064,210,33,2,1,12,8,10,7,True,True
10065,210,34,1,0,15,8,14,8,True,True
10066,210,35,0,0,15,8,15,8,True,True
10067,210,36,2,2,15,10,13,8,True,True
10068,210,37,3,0,34,11,31,11,True,True
10069,210,38,2,1,25,11,23,10,True,True
10070,210,39,3,0,27,15,24,15,True,True
10071,210,40,3,1,12,10,9,9,True,True
10072,210,41,2,0,24,10,22,10,True,True
10073,210,42,2,0,26,17,24,17,True,True
10074,210,43,3,0,41,8,38,8,True,True
10075,210,44,4,0,41,16,37,16,True,True
10076,210,45,4,0,55,17,51,17,True,True
10077,210,46,1,0,48,10,47,10,True,True
10078,210,47,1,0,49,15,48,15,True,True
10079,210,48,0,2,61,20,61,18,True,True
10080,211,1,2440,1731,1545,1204,-895,-527,False,False
10081,211,2,2042,1708,1264,1184,-778,-524,False,False
10082,211,3,1524,1578,906,1055,-618,-523,False,False
10083,211,4,1144,1607,698,919,-446,-688,False,False
10084,211,5,740,1423,517,786,-223,-637,False,False
10085,211,6,612,1126,435,655,-177,-471,False,False
10086,211,7,404,849,318,596,-86,-253,False,False
10087,211,8,308,631,266,562,-42,-69,False,False
10088,211,9,267,504,207,421,-60,-83,False,False
10089,211,10,225,364,191,224,-34,-140,False,False
10090,211,11,200,214,114,121,-86,-93,False,False
10091,211,12,396,164,257,105,-139,-59,False,False
10092,211,13,487,166,368,118,-119,-48,False,False
10093,211,14,970,174,503,126,-467,-48,False,False
10094,211,15,1069,207,644,137,-425,-70,False,False
10095,211,16,1285,217,1055,210,-230,-7,False,False
10096,211,17,1527,254,1389,276,-138,22,False,True
10097,211,18,2007,352,2310,469,303,117,True,True
10098,211,19,2043,477,3129,583,1086,106,True,True
10099,211,20,2140,607,3426,883,1286,276,True,True
10100,211,21,1879,637,3435,1104,1556,467,True,True
10101,211,22,1988,768,3161,1315,1173,547,True,True
10102,211,23,1928,891,3002,1534,1074,643,True,True
10103,211,24,2224,954,2870,1608,646,654,True,True
10104,211,25,2351,1134,3140,1830,789,696,True,True
10105,211,26,2463,1300,3294,1846,831,546,True,True
10106,211,27,2488,1487,3216,1892,728,405,True,True
10107,211,28,2616,1477,3166,1905,550,428,True,True
10108,211,29,2739,1504,3012,1701,273,197,True,True
10109,211,30,2625,1542,2854,1690,229,148,True,True
10110,211,31,2471,1496,2788,1549,317,53,True,True
10111,211,32,2042,1393,2517,1511,475,118,True,True
10112,211,33,1697,1253,2378,1398,681,145,True,True
10113,211,34,1516,1066,1956,1183,440,117,True,True
10114,211,35,1806,1102,1966,1131,160,29,True,True
10115,211,36,2117,1374,2327,1303,210,-71,True,False
10116,211,37,2627,1601,2641,1431,14,-170,True,False
10117,211,38,3010,1606,3245,1487,235,-119,True,False
10118,211,39,3601,1870,3778,1559,177,-311,True,False
10119,211,40,3896,1689,3938,1628,42,-61,True,False
10120,211,41,4039,1719,3901,1672,-138,-47,False,False
10121,211,42,3930,1611,3792,1533,-138,-78,False,False
10122,211,43,3819,1581,3141,1443,-678,-138,False,False
10123,211,44,3656,1446,2907,1369,-749,-77,False,False
10124,211,45,3487,1500,2579,1324,-908,-176,False,False
10125,211,46,3336,1448,2481,1217,-855,-231,False,False
10126,211,47,3389,1446,2302,1194,-1087,-252,False,False
10127,211,48,3101,1356,2073,1084,-1028,-272,False,False
10128,212,1,3,1,22,20,19,19,True,True
10129,212,2,1,1,38,27,37,26,True,True
10130,212,3,1,3,39,26,38,23,True,True
10131,212,4,2,0,31,18,29,18,True,True
10132,212,5,1,1,12,29,11,28,True,True
10133,212,6,2,0,26,16,24,16,True,True
10134,212,7,1,1,21,19,20,18,True,True
10135,212,8,0,1,16,23,16,22,True,True
10136,212,9,1,2,13,22,12,20,True,True
10137,212,10,2,5,17,26,15,21,True,True
10138,212,11,1,0,14,25,13,25,True,True
10139,212,12,3,1,7,18,4,17,True,True
10140,212,13,0,2,7,10,7,8,True,True
10141,212,14,3,3,11,5,8,2,True,True
10142,212,15,0,0,5,9,5,9,True,True
10143,212,16,2,2,3,10,1,8,True,True
10144,212,17,0,0,6,6,6,6,True,True
10145,212,18,2,1,7,9,5,8,True,True
10146,212,19,3,1,8,4,5,3,True,True
10147,212,20,1,0,4,2,3,2,True,True
10148,212,21,1,1,8,3,7,2,True,True
10149,212,22,2,0,7,3,5,3,True,True
10150,212,23,0,0,5,4,5,4,True,True
10151,212,24,1,0,2,2,1,2,True,True
10152,212,25,1,1,8,3,7,2,True,True
10153,212,26,1,0,5,2,4,2,True,True
10154,212,27,1,0,7,5,6,5,True,True
10155,212,28,1,0,8,2,7,2,True,True
10156,212,29,0,0,6,4,6,4,True,True
10157,212,30,1,0,9,6,8,6,True,True
10158,212,31,0,0,6,4,6,4,True,True
10159,212,32,0,1,5,4,5,3,True,True
10160,212,33,2,2,6,3,4,1,True,True
10161,212,34,0,1,9,10,9,9,True,True
10162,212,35,0,1,2,2,2,1,True,True
10163,212,36,0,2,8,4,8,2,True,True
10164,212,37,0,1,12,5,12,4,True,True
10165,212,38,3,0,8,3,5,3,True,True
10166,212,39,3,0,15,4,12,4,True,True
10167,212,40,3,0,11,9,8,9,True,True
10168,212,41,1,0,14,7,13,7,True,True
10169,212,42,1,0,13,4,12,4,True,True
10170,212,43,4,2,31,8,27,6,True,True
10171,212,44,3,4,32,23,29,19,True,True
10172,212,45,3,0,30,14,27,14,True,True
10173,212,46,0,0,28,13,28,13,True,True
10174,212,47,2,1,28,20,26,19,True,True
10175,212,48,1,3,33,18,32,15,True,True
10176,213,1,5,2,36,21,31,19,True,True
10177,213,2,0,0,36,30,36,30,True,True
10178,213,3,3,0,37,22,34,22,True,True
10179,213,4,2,1,20,23,18,22,True,True
10180,213,5,2,1,24,23,22,22,True,True
10181,213,6,0,1,21,19,21,18,True,True
10182,213,7,2,0,15,22,13,22,True,True
10183,213,8,1,3,13,24,12,21,True,True
10184,213,9,0,1,13,23,13,22,True,True
10185,213,10,0,2,14,35,14,33,True,True
10186,213,11,0,1,14,18,14,17,True,True
10187,213,12,3,1,14,15,11,14,True,True
10188,213,13,3,2,11,11,8,9,True,True
10189,213,14,0,0,11,6,11,6,True,True
10190,213,15,1,1,9,13,8,12,True,True
10191,213,16,1,1,16,9,15,8,True,True
10192,213,17,1,1,9,6,8,5,True,True
10193,213,18,1,0,5,8,4,8,True,True
10194,213,19,1,0,14,7,13,7,True,True
10195,213,20,0,1,10,12,10,11,True,True
10196,213,21,0,1,17,10,17,9,True,True
10197,213,22,1,1,10,11,9,10,True,True
10198,213,23,3,2,14,8,11,6,True,True
10199,213,24,0,2,13,9,13,7,True,True
10200,213,25,1,0,8,4,7,4,True,True
10201,213,26,0,2,14,9,14,7,True,True
10202,213,27,1,3,19,9,18,6,True,True
10203,213,28,0,3,8,11,8,8,True,True
10204,213,29,1,2,19,12,18,10,True,True
10205,213,30,1,2,12,6,11,4,True,True
10206,213,31,0,0,14,5,14,5,True,True
10207,213,32,0,0,12,7,12,7,True,True
10208,213,33,0,1,9,9,9,8,True,True
10209,213,34,2,0,12,2,10,2,True,True
10210,213,35,1,0,10,3,9,3,True,True
10211,213,36,3,0,15,14,12,14,True,True
10212,213,37,3,1,12,17,9,16,True,True
10213,213,38,0,0,15,9,15,9,True,True
10214,213,39,1,0,20,11,19,11,True,True
10215,213,40,1,1,19,8,18,7,True,True
10216,213,41,0,1,18,11,18,10,True,True
10217,213,42,1,0,34,18,33,18,True,True
10218,213,43,0,1,27,17,27,16,True,True
10219,213,44,0,1,45,14,45,13,True,True
10220,213,45,0,0,40,17,40,17,True,True
10221,213,46,1,0,46,13,45,13,True,True
10222,213,47,4,2,38,22,34,20,True,True
10223,213,48,2,0,50,19,48,19,True,True
10224,214,1,0,0,6,2,6,2,True,True
10225,214,2,0,0,8,3,8,3,True,True
10226,214,3,0,1,6,5,6,4,True,True
10227,214,4,0,0,6,4,6,4,True,True
10228,214,5,0,0,4,1,4,1,True,True
10229,214,6,0,0,2,4,2,4,True,True
10230,214,7,0,0,2,1,2,1,True,True
10231,214,8,0,0,1,2,1,2,True,True
10232,214,9,0,0,3,1,3,1,True,True
10233,214,10,0,0,1,1,1,1,True,True
10234,214,11,0,0,0,6,0,6,False,True
10235,214,12,0,0,0,2,0,2,False,True
10236,214,13,0,0,1,1,1,1,True,True
10237,214,14,1,0,3,1,2,1,True,True
10238,214,15,0,0,1,1,1,1,True,True
10239,214,16,0,0,1,0,1,0,True,False
10240,214,17,0,0,1,1,1,1,True,True
10241,214,18,0,0,1,2,1,2,True,True
10242,214,19,0,0,2,1,2,1,True,True
10243,214,20,0,0,6,0,6,0,True,False
10244,214,21,0,0,1,0,1,0,True,False
10245,214,22,0,0,1,0,1,0,True,False
10246,214,23,0,0,1,3,1,3,True,True
10247,214,24,1,0,2,0,1,0,True,False
10248,214,25,0,0,1,0,1,0,True,False
10249,214,26,0,0,0,1,0,1,False,True
10250,214,27,0,0,3,0,3,0,True,False
10251,214,28,1,0,2,0,1,0,True,False
10252,214,29,0,0,3,0,3,0,True,False
10253,214,30,0,0,2,1,2,1,True,True
10254,214,31,0,0,2,1,2,1,True,True
10255,214,32,0,0,2,2,2,2,True,True
10256,214,33,0,0,1,2,1,2,True,True
10257,214,34,0,0,0,2,0,2,False,True
10258,214,35,0,0,0,0,0,0,False,False
10259,214,36,0,0,1,2,1,2,True,True
10260,214,37,0,1,2,2,2,1,True,True
10261,214,38,0,1,2,3,2,2,True,True
10262,214,39,0,0,2,0,2,0,True,False
10263,214,40,1,0,6,2,5,2,True,True
10264,214,41,0,0,7,0,7,0,True,False
10265,214,42,0,0,10,0,10,0,True,False
10266,214,43,0,0,13,3,13,3,True,True
10267,214,44,0,0,10,1,10,1,True,True
10268,214,45,0,0,16,1,16,1,True,True
10269,214,46,0,0,9,1,9,1,True,True
10270,214,47,0,0,10,1,10,1,True,True
10271,214,48,0,0,8,1,8,1,True,True
10272,215,1,6,1,35,10,29,9,True,True
10273,215,2,6,3,31,15,25,12,True,True
10274,215,3,5,3,27,11,22,8,True,True
10275,215,4,2,0,31,8,29,8,True,True
10276,215,5,2,0,23,5,21,5,True,True
10277,215,6,0,1,10,15,10,14,True,True
10278,215,7,0,1,7,5,7,4,True,True
10279,215,8,1,0,5,12,4,12,True,True
10280,215,9,1,0,2,7,1,7,True,True
10281,215,10,2,3,3,13,1,10,True,True
10282,215,11,0,1,8,4,8,3,True,True
10283,215,12,4,0,4,1,0,1,False,True
10284,215,13,11,4,4,4,-7,0,False,False
10285,215,14,21,3,6,8,-15,5,False,True
10286,215,15,19,2,6,6,-13,4,False,True
10287,215,16,21,2,8,7,-13,5,False,True
10288,215,17,18,3,9,2,-9,-1,False,False
10289,215,18,10,4,11,8,1,4,True,True
10290,215,19,7,5,6,5,-1,0,False,False
10291,215,20,7,2,10,8,3,6,True,True
10292,215,21,7,3,9,8,2,5,True,True
10293,215,22,6,4,6,5,0,1,False,True
10294,215,23,14,3,8,5,-6,2,False,True
10295,215,24,17,3,11,3,-6,0,False,False
10296,215,25,9,3,4,5,-5,2,False,True
10297,215,26,14,6,6,8,-8,2,False,True
10298,215,27,15,4,12,5,-3,1,False,True
10299,215,28,24,11,11,6,-13,-5,False,False
10300,215,29,19,5,9,10,-10,5,False,True
10301,215,30,11,6,11,6,0,0,False,False
10302,215,31,20,14,11,8,-9,-6,False,False
10303,215,32,24,11,10,7,-14,-4,False,False
10304,215,33,25,14,18,7,-7,-7,False,False
10305,215,34,34,12,12,7,-22,-5,False,False
10306,215,35,22,3,9,4,-13,1,False,True
10307,215,36,23,5,12,5,-11,0,False,False
10308,215,37,24,17,8,8,-16,-9,False,False
10309,215,38,17,12,14,11,-3,-1,False,False
10310,215,39,11,15,16,11,5,-4,True,False
10311,215,40,6,9,13,9,7,0,True,False
10312,215,41,8,10,24,11,16,1,True,True
10313,215,42,13,11,19,11,6,0,True,False
10314,215,43,15,11,21,13,6,2,True,True
10315,215,44,8,5,30,10,22,5,True,True
10316,215,45,6,7,21,9,15,2,True,True
10317,215,46,14,7,23,17,9,10,True,True
10318,215,47,7,5,26,10,19,5,True,True
10319,215,48,8,3,25,13,17,10,True,True
10320,216,1,7,4,110,55,103,51,True,True
10321,216,2,6,6,110,47,104,41,True,True
10322,216,3,5,5,100,44,95,39,True,True
10323,216,4,9,6,73,40,64,34,True,True
10324,216,5,7,6,46,34,39,28,True,True
10325,216,6,1,8,23,33,22,25,True,True
10326,216,7,4,5,33,36,29,31,True,True
10327,216,8,3,4,14,19,11,15,True,True
10328,216,9,9,9,25,29,16,20,True,True
10329,216,10,3,3,23,20,20,17,True,True
10330,216,11,10,5,25,24,15,19,True,True
10331,216,12,4,4,43,27,39,23,True,True
10332,216,13,9,6,30,27,21,21,True,True
10333,216,14,10,1,48,16,38,15,True,True
10334,216,15,8,5,51,26,43,21,True,True
10335,216,16,7,4,44,17,37,13,True,True
10336,216,17,11,2,41,32,30,30,True,True
10337,216,18,13,3,38,16,25,13,True,True
10338,216,19,6,4,41,34,35,30,True,True
10339,216,20,8,5,39,17,31,12,True,True
10340,216,21,2,4,38,26,36,22,True,True
10341,216,22,9,2,44,19,35,17,True,True
10342,216,23,4,6,43,18,39,12,True,True
10343,216,24,12,4,45,30,33,26,True,True
10344,216,25,9,4,50,22,41,18,True,True
10345,216,26,13,1,50,20,37,19,True,True
10346,216,27,14,6,49,23,35,17,True,True
10347,216,28,13,6,60,30,47,24,True,True
10348,216,29,17,4,69,38,52,34,True,True
10349,216,30,18,6,89,41,71,35,True,True
10350,216,31,13,4,105,44,92,40,True,True
10351,216,32,15,11,123,47,108,36,True,True
10352,216,33,24,4,125,55,101,51,True,True
10353,216,34,9,10,113,37,104,27,True,True
10354,216,35,15,12,86,48,71,36,True,True
10355,216,36,12,9,84,52,72,43,True,True
10356,216,37,18,7,86,43,68,36,True,True
10357,216,38,16,14,69,35,53,21,True,True
10358,216,39,17,9,98,34,81,25,True,True
10359,216,40,13,7,65,44,52,37,True,True
10360,216,41,8,9,92,49,84,40,True,True
10361,216,42,12,3,83,41,71,38,True,True
10362,216,43,8,4,88,34,80,30,True,True
10363,216,44,9,7,108,45,99,38,True,True
10364,216,45,9,7,99,47,90,40,True,True
10365,216,46,10,8,126,50,116,42,True,True
10366,216,47,7,4,120,58,113,54,True,True
10367,216,48,10,5,128,64,118,59,True,True
10368,217,1,71,55,132,85,61,30,True,True
10369,217,2,61,53,131,74,70,21,True,True
10370,217,3,59,79,113,86,54,7,True,True
10371,217,4,38,71,110,94,72,23,True,True
10372,217,5,35,85,80,71,45,-14,True,False
10373,217,6,39,70,66,60,27,-10,True,False
10374,217,7,22,46,53,66,31,20,True,True
10375,217,8,18,42,50,58,32,16,True,True
10376,217,9,18,49,44,70,26,21,True,True
10377,217,10,10,30,28,39,18,9,True,True
10378,217,11,8,9,16,29,8,20,True,True
10379,217,12,6,10,16,18,10,8,True,True
10380,217,13,6,14,16,14,10,0,True,False
10381,217,14,2,5,14,13,12,8,True,True
10382,217,15,2,3,18,11,16,8,True,True
10383,217,16,2,1,19,6,17,5,True,True
10384,217,17,3,6,27,8,24,2,True,True
10385,217,18,8,1,33,15,25,14,True,True
10386,217,19,9,5,35,8,26,3,True,True
10387,217,20,1,7,29,16,28,9,True,True
10388,217,21,3,6,38,13,35,7,True,True
10389,217,22,8,5,47,9,39,4,True,True
10390,217,23,7,9,57,8,50,-1,True,False
10391,217,24,8,5,63,25,55,20,True,True
10392,217,25,5,3,77,15,72,12,True,True
10393,217,26,13,6,79,17,66,11,True,True
10394,217,27,17,7,77,21,60,14,True,True
10395,217,28,10,3,76,16,66,13,True,True
10396,217,29,5,11,77,23,72,12,True,True
10397,217,30,9,7,91,19,82,12,True,True
10398,217,31,11,8,96,31,85,23,True,True
10399,217,32,7,6,87,30,80,24,True,True
10400,217,33,8,3,66,22,58,19,True,True
10401,217,34,8,9,69,41,61,32,True,True
10402,217,35,10,12,57,20,47,8,True,True
10403,217,36,10,11,68,19,58,8,True,True
10404,217,37,13,10,93,50,80,40,True,True
10405,217,38,18,10,85,43,67,33,True,True
10406,217,39,24,10,90,42,66,32,True,True
10407,217,40,14,14,72,49,58,35,True,True
10408,217,41,28,19,82,39,54,20,True,True
10409,217,42,32,20,86,50,54,30,True,True
10410,217,43,38,23,107,34,69,11,True,True
10411,217,44,40,18,112,49,72,31,True,True
10412,217,45,36,28,127,57,91,29,True,True
10413,217,46,48,32,125,63,77,31,True,True
10414,217,47,54,32,141,62,87,30,True,True
10415,217,48,78,30,143,78,65,48,True,True
10416,218,1,3,0,59,21,56,21,True,True
10417,218,2,2,0,48,18,46,18,True,True
10418,218,3,2,1,42,25,40,24,True,True
10419,218,4,1,1,31,17,30,16,True,True
10420,218,5,1,1,24,9,23,8,True,True
10421,218,6,0,1,12,7,12,6,True,True
10422,218,7,0,0,8,5,8,5,True,True
10423,218,8,5,0,6,5,1,5,True,True
10424,218,9,1,0,3,8,2,8,True,True
10425,218,10,3,0,7,8,4,8,True,True
10426,218,11,1,0,3,5,2,5,True,True
10427,218,12,2,1,4,3,2,2,True,True
10428,218,13,1,0,7,2,6,2,True,True
10429,218,14,7,0,7,3,0,3,False,True
10430,218,15,0,0,11,4,11,4,True,True
10431,218,16,0,0,10,1,10,1,True,True
10432,218,17,0,1,6,6,6,5,True,True
10433,218,18,1,0,5,9,4,9,True,True
10434,218,19,2,1,14,3,12,2,True,True
10435,218,20,2,0,15,4,13,4,True,True
10436,218,21,1,0,10,6,9,6,True,True
10437,218,22,0,2,13,3,13,1,True,True
10438,218,23,0,0,16,3,16,3,True,True
10439,218,24,0,0,12,5,12,5,True,True
10440,218,25,1,0,12,2,11,2,True,True
10441,218,26,0,0,13,7,13,7,True,True
10442,218,27,0,0,11,4,11,4,True,True
10443,218,28,1,1,13,5,12,4,True,True
10444,218,29,0,0,12,8,12,8,True,True
10445,218,30,0,1,18,5,18,4,True,True
10446,218,31,3,0,16,6,13,6,True,True
10447,218,32,0,0,10,3,10,3,True,True
10448,218,33,2,0,21,19,19,19,True,True
10449,218,34,2,0,25,9,23,9,True,True
10450,218,35,1,3,17,8,16,5,True,True
10451,218,36,1,4,15,12,14,8,True,True
10452,218,37,0,2,21,19,21,17,True,True
10453,218,38,1,2,24,14,23,12,True,True
10454,218,39,1,1,34,7,33,6,True,True
10455,218,40,1,0,26,12,25,12,True,True
10456,218,41,3,1,39,12,36,11,True,True
10457,218,42,2,3,40,20,38,17,True,True
10458,218,43,1,0,41,9,40,9,True,True
10459,218,44,0,1,32,16,32,15,True,True
10460,218,45,2,1,44,17,42,16,True,True
10461,218,46,2,0,40,16,38,16,True,True
10462,218,47,0,0,38,20,38,20,True,True
10463,218,48,2,2,34,18,32,16,True,True
10464,219,1,16,2,63,25,47,23,True,True
10465,219,2,13,7,58,25,45,18,True,True
10466,219,3,16,3,50,14,34,11,True,True
10467,219,4,9,1,31,16,22,15,True,True
10468,219,5,15,1,27,14,12,13,True,True
10469,219,6,1,1,11,7,10,6,True,True
10470,219,7,1,0,8,10,7,10,True,True
10471,219,8,1,2,7,8,6,6,True,True
10472,219,9,5,0,5,3,0,3,False,True
10473,219,10,5,1,4,2,-1,1,False,True
10474,219,11,3,2,6,4,3,2,True,True
10475,219,12,12,2,11,6,-1,4,False,True
10476,219,13,9,3,17,14,8,11,True,True
10477,219,14,9,6,8,6,-1,0,False,False
10478,219,15,16,3,21,11,5,8,True,True
10479,219,16,24,4,15,6,-9,2,False,True
10480,219,17,17,4,19,7,2,3,True,True
10481,219,18,17,3,22,5,5,2,True,True
10482,219,19,10,3,21,6,11,3,True,True
10483,219,20,16,5,23,9,7,4,True,True
10484,219,21,3,6,15,6,12,0,True,False
10485,219,22,7,4,13,10,6,6,True,True
10486,219,23,11,3,20,6,9,3,True,True
10487,219,24,14,2,20,4,6,2,True,True
10488,219,25,8,4,20,7,12,3,True,True
10489,219,26,11,7,22,6,11,-1,True,False
10490,219,27,19,6,26,13,7,7,True,True
10491,219,28,19,4,31,10,12,6,True,True
10492,219,29,21,5,29,12,8,7,True,True
10493,219,30,25,14,29,8,4,-6,True,False
10494,219,31,25,6,37,13,12,7,True,True
10495,219,32,23,11,37,19,14,8,True,True
10496,219,33,25,13,44,25,19,12,True,True
10497,219,34,19,14,26,19,7,5,True,True
10498,219,35,21,12,34,29,13,17,True,True
10499,219,36,22,11,44,19,22,8,True,True
10500,219,37,25,16,43,31,18,15,True,True
10501,219,38,19,15,46,31,27,16,True,True
10502,219,39,13,8,39,25,26,17,True,True
10503,219,40,13,14,50,25,37,11,True,True
10504,219,41,18,18,61,29,43,11,True,True
10505,219,42,7,8,59,32,52,24,True,True
10506,219,43,14,7,69,35,55,28,True,True
10507,219,44,15,8,69,34,54,26,True,True
10508,219,45,20,6,92,34,72,28,True,True
10509,219,46,14,10,63,35,49,25,True,True
10510,219,47,16,6,94,22,78,16,True,True
10511,219,48,13,4,58,45,45,41,True,True
10512,220,1,8,2,147,75,139,73,True,True
10513,220,2,1,3,109,76,108,73,True,True
10514,220,3,4,2,89,80,85,78,True,True
10515,220,4,4,5,65,94,61,89,True,True
10516,220,5,0,6,52,96,52,90,True,True
10517,220,6,1,7,55,83,54,76,True,True
10518,220,7,1,2,45,86,44,84,True,True
10519,220,8,1,9,32,73,31,64,True,True
10520,220,9,5,6,32,58,27,52,True,True
10521,220,10,0,2,18,43,18,41,True,True
10522,220,11,3,4,24,36,21,32,True,True
10523,220,12,0,1,11,16,11,15,True,True
10524,220,13,0,0,22,17,22,17,True,True
10525,220,14,0,1,20,14,20,13,True,True
10526,220,15,1,1,18,9,17,8,True,True
10527,220,16,2,0,25,15,23,15,True,True
10528,220,17,3,1,29,15,26,14,True,True
10529,220,18,1,0,17,10,16,10,True,True
10530,220,19,3,1,30,19,27,18,True,True
10531,220,20,3,1,46,16,43,15,True,True
10532,220,21,2,1,20,18,18,17,True,True
10533,220,22,0,2,25,30,25,28,True,True
10534,220,23,2,2,31,22,29,20,True,True
10535,220,24,5,3,23,21,18,18,True,True
10536,220,25,2,3,37,18,35,15,True,True
10537,220,26,2,0,44,16,42,16,True,True
10538,220,27,1,0,37,24,36,24,True,True
10539,220,28,2,1,37,28,35,27,True,True
10540,220,29,0,1,37,15,37,14,True,True
10541,220,30,2,2,54,20,52,18,True,True
10542,220,31,3,1,55,17,52,16,True,True
10543,220,32,3,1,39,27,36,26,True,True
10544,220,33,3,2,32,26,29,24,True,True
10545,220,34,0,1,42,20,42,19,True,True
10546,220,35,2,6,42,32,40,26,True,True
10547,220,36,0,1,43,33,43,32,True,True
10548,220,37,1,2,45,31,44,29,True,True
10549,220,38,3,4,84,33,81,29,True,True
10550,220,39,4,1,85,26,81,25,True,True
10551,220,40,5,1,104,26,99,25,True,True
10552,220,41,3,2,128,33,125,31,True,True
10553,220,42,4,1,141,31,137,30,True,True
10554,220,43,2,2,158,45,156,43,True,True
10555,220,44,3,3,198,40,195,37,True,True
10556,220,45,5,2,177,51,172,49,True,True
10557,220,46,5,3,174,45,169,42,True,True
10558,220,47,2,6,176,62,174,56,True,True
10559,220,48,7,1,174,48,167,47,True,True
10560,221,1,0,0,6,4,6,4,True,True
10561,221,2,1,0,2,2,1,2,True,True
10562,221,3,1,1,6,3,5,2,True,True
10563,221,4,0,1,3,2,3,1,True,True
10564,221,5,0,0,5,6,5,6,True,True
10565,221,6,0,2,4,5,4,3,True,True
10566,221,7,0,0,1,6,1,6,True,True
10567,221,8,0,0,1,4,1,4,True,True
10568,221,9,0,1,1,5,1,4,True,True
10569,221,10,0,0,0,5,0,5,False,True
10570,221,11,1,0,1,3,0,3,False,True
10571,221,12,2,1,3,1,1,0,True,False
10572,221,13,0,0,0,2,0,2,False,True
10573,221,14,0,0,0,0,0,0,False,False
10574,221,15,3,0,4,2,1,2,True,True
10575,221,16,2,0,3,0,1,0,True,False
10576,221,17,3,0,3,2,0,2,False,True
10577,221,18,1,0,2,1,1,1,True,True
10578,221,19,2,0,2,1,0,1,False,True
10579,221,20,0,0,0,0,0,0,False,False
10580,221,21,0,0,1,0,1,0,True,False
10581,221,22,0,1,2,1,2,0,True,False
10582,221,23,0,0,0,1,0,1,False,True
10583,221,24,0,0,2,2,2,2,True,True
10584,221,25,0,0,1,0,1,0,True,False
10585,221,26,0,0,2,0,2,0,True,False
10586,221,27,0,0,4,1,4,1,True,True
10587,221,28,0,0,2,0,2,0,True,False
10588,221,29,0,0,3,1,3,1,True,True
10589,221,30,0,0,2,0,2,0,True,False
10590,221,31,0,0,1,1,1,1,True,True
10591,221,32,0,0,0,1,0,1,False,True
10592,221,33,0,0,1,1,1,1,True,True
10593,221,34,0,0,4,1,4,1,True,True
10594,221,35,0,0,1,2,1,2,True,True
10595,221,36,0,0,3,2,3,2,True,True
10596,221,37,0,0,2,1,2,1,True,True
10597,221,38,0,0,6,0,6,0,True,False
10598,221,39,0,0,2,1,2,1,True,True
10599,221,40,0,0,4,5,4,5,True,True
10600,221,41,0,0,3,2,3,2,True,True
10601,221,42,0,0,7,1,7,1,True,True
10602,221,43,1,0,6,0,5,0,True,False
10603,221,44,2,0,11,5,9,5,True,True
10604,221,45,0,0,9,0,9,0,True,False
10605,221,46,1,0,7,1,6,1,True,True
10606,221,47,0,0,6,1,6,1,True,True
10607,221,48,0,1,10,2,10,1,True,True
10608,222,1,1,0,4,1,3,1,True,True
10609,222,2,0,0,15,3,15,3,True,True
10610,222,3,0,0,5,4,5,4,True,True
10611,222,4,0,0,5,5,5,5,True,True
10612,222,5,0,0,4,3,4,3,True,True
10613,222,6,0,0,4,2,4,2,True,True
10614,222,7,0,0,2,10,2,10,True,True
10615,222,8,0,0,6,4,6,4,True,True
10616,222,9,1,0,4,4,3,4,True,True
10617,222,10,0,0,1,2,1,2,True,True
10618,222,11,0,0,1,4,1,4,True,True
10619,222,12,0,0,1,1,1,1,True,True
10620,222,13,1,0,1,1,0,1,False,True
10621,222,14,0,1,2,2,2,1,True,True
10622,222,15,0,0,3,0,3,0,True,False
10623,222,16,0,0,2,1,2,1,True,True
10624,222,17,0,0,6,0,6,0,True,False
10625,222,18,0,0,2,2,2,2,True,True
10626,222,19,0,0,5,1,5,1,True,True
10627,222,20,0,0,2,2,2,2,True,True
10628,222,21,1,1,4,3,3,2,True,True
10629,222,22,0,0,1,2,1,2,True,True
10630,222,23,0,0,2,4,2,4,True,True
10631,222,24,0,0,3,1,3,1,True,True
10632,222,25,1,0,4,3,3,3,True,True
10633,222,26,0,0,7,1,7,1,True,True
10634,222,27,0,0,3,0,3,0,True,False
10635,222,28,0,0,6,0,6,0,True,False
10636,222,29,1,0,8,2,7,2,True,True
10637,222,30,0,0,8,3,8,3,True,True
10638,222,31,1,0,5,2,4,2,True,True
10639,222,32,1,0,4,2,3,2,True,True
10640,222,33,1,0,7,0,6,0,True,False
10641,222,34,1,0,6,2,5,2,True,True
10642,222,35,2,0,5,1,3,1,True,True
10643,222,36,0,0,2,0,2,0,True,False
10644,222,37,0,0,2,2,2,2,True,True
10645,222,38,0,0,8,4,8,4,True,True
10646,222,39,0,0,10,1,10,1,True,True
10647,222,40,1,0,5,1,4,1,True,True
10648,222,41,0,0,4,2,4,2,True,True
10649,222,42,0,0,8,4,8,4,True,True
10650,222,43,0,0,6,1,6,1,True,True
10651,222,44,1,0,4,2,3,2,True,True
10652,222,45,1,0,3,1,2,1,True,True
10653,222,46,0,1,14,2,14,1,True,True
10654,222,47,0,0,5,3,5,3,True,True
10655,222,48,0,0,12,4,12,4,True,True
10656,223,1,263,227,1290,576,1027,349,True,True
10657,223,2,234,232,1393,732,1159,500,True,True
10658,223,3,188,235,1161,808,973,573,True,True
10659,223,4,152,217,877,790,725,573,True,True
10660,223,5,136,226,717,818,581,592,True,True
10661,223,6,106,155,613,823,507,668,True,True
10662,223,7,74,154,501,719,427,565,True,True
10663,223,8,74,131,412,684,338,553,True,True
10664,223,9,95,137,353,668,258,531,True,True
10665,223,10,112,142,361,509,249,367,True,True
10666,223,11,148,103,250,331,102,228,True,True
10667,223,12,215,111,209,230,-6,119,False,True
10668,223,13,243,113,193,143,-50,30,False,True
10669,223,14,357,90,241,115,-116,25,False,True
10670,223,15,417,84,284,107,-133,23,False,True
10671,223,16,555,126,257,110,-298,-16,False,False
10672,223,17,455,129,268,94,-187,-35,False,False
10673,223,18,345,145,241,117,-104,-28,False,False
10674,223,19,296,128,259,122,-37,-6,False,False
10675,223,20,217,154,176,113,-41,-41,False,False
10676,223,21,175,130,157,131,-18,1,False,True
10677,223,22,145,136,183,129,38,-7,True,False
10678,223,23,145,122,190,131,45,9,True,True
10679,223,24,148,110,182,123,34,13,True,True
10680,223,25,116,110,192,136,76,26,True,True
10681,223,26,129,96,160,114,31,18,True,True
10682,223,27,116,102,194,131,78,29,True,True
10683,223,28,109,94,200,137,91,43,True,True
10684,223,29,106,99,195,127,89,28,True,True
10685,223,30,130,110,258,153,128,43,True,True
10686,223,31,113,85,211,161,98,76,True,True
10687,223,32,100,71,185,159,85,88,True,True
10688,223,33,106,78,204,166,98,88,True,True
10689,223,34,121,82,218,139,97,57,True,True
10690,223,35,147,87,258,150,111,63,True,True
10691,223,36,160,91,336,174,176,83,True,True
10692,223,37,160,99,410,214,250,115,True,True
10693,223,38,131,95,424,186,293,91,True,True
10694,223,39,117,85,486,218,369,133,True,True
10695,223,40,99,82,508,215,409,133,True,True
10696,223,41,99,82,459,214,360,132,True,True
10697,223,42,129,82,583,242,454,160,True,True
10698,223,43,143,91,683,222,540,131,True,True
10699,223,44,161,91,769,250,608,159,True,True
10700,223,45,183,110,914,298,731,188,True,True
10701,223,46,215,129,1068,332,853,203,True,True
10702,223,47,234,154,1193,353,959,199,True,True
10703,223,48,246,142,1332,439,1086,297,True,True
10704,224,1,432,651,1359,798,927,147,True,True
10705,224,2,316,582,1115,847,799,265,True,True
10706,224,3,263,431,804,777,541,346,True,True
10707,224,4,164,304,581,791,417,487,True,True
10708,224,5,125,297,436,818,311,521,True,True
10709,224,6,97,230,350,728,253,498,True,True
10710,224,7,101,231,299,690,198,459,True,True
10711,224,8,97,202,232,587,135,385,True,True
10712,224,9,137,240,207,483,70,243,True,True
10713,224,10,199,167,149,275,-50,108,False,True
10714,224,11,316,150,101,167,-215,17,False,True
10715,224,12,555,133,79,136,-476,3,False,True
10716,224,13,854,167,114,93,-740,-74,False,False
10717,224,14,1343,240,219,86,-1124,-154,False,False
10718,224,15,1424,271,243,74,-1181,-197,False,False
10719,224,16,1235,374,302,107,-933,-267,False,False
10720,224,17,981,392,318,124,-663,-268,False,False
10721,224,18,596,524,268,137,-328,-387,False,False
10722,224,19,561,538,239,173,-322,-365,False,False
10723,224,20,714,677,240,237,-474,-440,False,False
10724,224,21,898,655,273,246,-625,-409,False,False
10725,224,22,974,750,309,302,-665,-448,False,False
10726,224,23,792,697,373,322,-419,-375,False,False
10727,224,24,818,796,406,336,-412,-460,False,False
10728,224,25,768,667,511,350,-257,-317,False,False
10729,224,26,685,715,477,408,-208,-307,False,False
10730,224,27,592,623,504,398,-88,-225,False,False
10731,224,28,566,528,480,344,-86,-184,False,False
10732,224,29,590,523,521,375,-69,-148,False,False
10733,224,30,565,466,580,378,15,-88,True,False
10734,224,31,506,424,600,422,94,-2,True,False
10735,224,32,441,396,652,429,211,33,True,True
10736,224,33,405,364,672,483,267,119,True,True
10737,224,34,385,334,624,433,239,99,True,True
10738,224,35,504,347,797,430,293,83,True,True
10739,224,36,588,416,979,504,391,88,True,True
10740,224,37,776,438,1264,589,488,151,True,True
10741,224,38,902,474,1483,592,581,118,True,True
10742,224,39,916,535,1632,584,716,49,True,True
10743,224,40,954,487,1765,567,811,80,True,True
10744,224,41,900,419,1709,646,809,227,True,True
10745,224,42,882,431,1784,658,902,227,True,True
10746,224,43,924,478,2025,750,1101,272,True,True
10747,224,44,847,471,2077,728,1230,257,True,True
10748,224,45,794,432,2035,770,1241,338,True,True
10749,224,46,781,459,1928,792,1147,333,True,True
10750,224,47,779,476,1818,741,1039,265,True,True
10751,224,48,655,462,1609,752,954,290,True,True
10752,225,1,51,44,534,201,483,157,True,True
10753,225,2,42,61,580,281,538,220,True,True
10754,225,3,33,89,554,402,521,313,True,True
10755,225,4,32,57,459,406,427,349,True,True
10756,225,5,36,76,428,419,392,343,True,True
10757,225,6,41,68,369,433,328,365,True,True
10758,225,7,30,53,312,391,282,338,True,True
10759,225,8,26,40,267,375,241,335,True,True
10760,225,9,27,37,238,390,211,353,True,True
10761,225,10,7,26,188,341,181,315,True,True
10762,225,11,7,14,125,202,118,188,True,True
10763,225,12,5,17,75,129,70,112,True,True
10764,225,13,7,7,46,66,39,59,True,True
10765,225,14,5,3,53,41,48,38,True,True
10766,225,15,3,5,61,20,58,15,True,True
10767,225,16,3,4,34,31,31,27,True,True
10768,225,17,5,4,30,30,25,26,True,True
10769,225,18,5,4,31,22,26,18,True,True
10770,225,19,8,3,28,18,20,15,True,True
10771,225,20,3,3,33,29,30,26,True,True
10772,225,21,0,1,20,28,20,27,True,True
10773,225,22,0,8,24,23,24,15,True,True
10774,225,23,3,3,25,27,22,24,True,True
10775,225,24,3,8,28,43,25,35,True,True
10776,225,25,2,2,37,34,35,32,True,True
10777,225,26,2,7,33,29,31,22,True,True
10778,225,27,2,4,53,39,51,35,True,True
10779,225,28,4,5,40,42,36,37,True,True
10780,225,29,1,9,44,48,43,39,True,True
10781,225,30,0,7,47,48,47,41,True,True
10782,225,31,5,5,41,42,36,37,True,True
10783,225,32,1,7,59,56,58,49,True,True
10784,225,33,1,6,31,47,30,41,True,True
10785,225,34,4,5,48,37,44,32,True,True
10786,225,35,7,6,54,47,47,41,True,True
10787,225,36,10,10,76,65,66,55,True,True
10788,225,37,3,3,89,68,86,65,True,True
10789,225,38,4,5,98,75,94,70,True,True
10790,225,39,7,4,125,78,118,74,True,True
10791,225,40,5,12,123,85,118,73,True,True
10792,225,41,14,3,164,95,150,92,True,True
10793,225,42,21,17,176,79,155,62,True,True
10794,225,43,19,13,251,118,232,105,True,True
10795,225,44,29,18,278,130,249,112,True,True
10796,225,45,26,26,338,130,312,104,True,True
10797,225,46,32,29,378,168,346,139,True,True
10798,225,47,42,29,425,191,383,162,True,True
10799,225,48,49,35,496,220,447,185,True,True
10800,226,1,398,287,1172,629,774,342,True,True
10801,226,2,343,303,1236,839,893,536,True,True
10802,226,3,333,327,1153,904,820,577,True,True
10803,226,4,256,279,992,956,736,677,True,True
10804,226,5,222,259,799,853,577,594,True,True
10805,226,6,226,282,604,798,378,516,True,True
10806,226,7,191,256,573,739,382,483,True,True
10807,226,8,190,268,507,675,317,407,True,True
10808,226,9,240,349,540,648,300,299,True,True
10809,226,10,236,242,426,601,190,359,True,True
10810,226,11,222,210,321,413,99,203,True,True
10811,226,12,458,210,307,300,-151,90,False,True
10812,226,13,553,210,270,232,-283,22,False,True
10813,226,14,662,219,268,177,-394,-42,False,False
10814,226,15,746,209,246,185,-500,-24,False,False
10815,226,16,902,232,307,130,-595,-102,False,False
10816,226,17,982,216,358,98,-624,-118,False,False
10817,226,18,919,302,369,158,-550,-144,False,False
10818,226,19,669,292,390,161,-279,-131,False,False
10819,226,20,481,350,300,182,-181,-168,False,False
10820,226,21,430,356,319,190,-111,-166,False,False
10821,226,22,394,326,313,159,-81,-167,False,False
10822,226,23,374,316,307,159,-67,-157,False,False
10823,226,24,360,279,309,169,-51,-110,False,False
10824,226,25,334,239,269,188,-65,-51,False,False
10825,226,26,339,239,323,166,-16,-73,False,False
10826,226,27,304,196,318,167,14,-29,True,False
10827,226,28,291,188,296,158,5,-30,True,False
10828,226,29,337,209,336,159,-1,-50,False,False
10829,226,30,342,239,316,181,-26,-58,False,False
10830,226,31,331,198,326,178,-5,-20,False,False
10831,226,32,318,189,268,192,-50,3,False,True
10832,226,33,305,206,293,175,-12,-31,False,False
10833,226,34,302,183,273,181,-29,-2,False,False
10834,226,35,345,240,279,197,-66,-43,False,False
10835,226,36,336,234,325,220,-11,-14,False,False
10836,226,37,301,205,330,214,29,9,True,True
10837,226,38,307,225,392,232,85,7,True,True
10838,226,39,310,174,448,265,138,91,True,True
10839,226,40,264,188,480,245,216,57,True,True
10840,226,41,281,189,536,260,255,71,True,True
10841,226,42,279,192,605,273,326,81,True,True
10842,226,43,316,185,715,315,399,130,True,True
10843,226,44,299,198,856,315,557,117,True,True
10844,226,45,328,222,947,387,619,165,True,True
10845,226,46,347,232,1038,442,691,210,True,True
10846,226,47,388,241,1083,492,695,251,True,True
10847,226,48,330,262,1211,589,881,327,True,True
10848,227,1,12,5,150,67,138,62,True,True
10849,227,2,9,4,155,69,146,65,True,True
10850,227,3,5,2,145,95,140,93,True,True
10851,227,4,6,4,110,85,104,81,True,True
10852,227,5,3,9,92,89,89,80,True,True
10853,227,6,1,2,67,94,66,92,True,True
10854,227,7,5,3,53,85,48,82,True,True
10855,227,8,2,7,53,76,51,69,True,True
10856,227,9,2,13,54,95,52,82,True,True
10857,227,10,0,6,29,80,29,74,True,True
10858,227,11,1,3,30,41,29,38,True,True
10859,227,12,2,4,17,31,15,27,True,True
10860,227,13,1,1,16,19,15,18,True,True
10861,227,14,4,1,15,13,11,12,True,True
10862,227,15,1,0,5,10,4,10,True,True
10863,227,16,3,1,16,5,13,4,True,True
10864,227,17,4,0,18,12,14,12,True,True
10865,227,18,9,2,33,7,24,5,True,True
10866,227,19,10,0,21,10,11,10,True,True
10867,227,20,7,2,16,8,9,6,True,True
10868,227,21,1,1,11,8,10,7,True,True
10869,227,22,3,3,9,12,6,9,True,True
10870,227,23,3,2,17,16,14,14,True,True
10871,227,24,3,3,10,14,7,11,True,True
10872,227,25,3,2,22,12,19,10,True,True
10873,227,26,2,1,14,13,12,12,True,True
10874,227,27,1,1,15,10,14,9,True,True
10875,227,28,1,0,22,14,21,14,True,True
10876,227,29,4,0,17,14,13,14,True,True
10877,227,30,2,0,12,4,10,4,True,True
10878,227,31,3,0,12,6,9,6,True,True
10879,227,32,3,0,21,11,18,11,True,True
10880,227,33,0,2,11,9,11,7,True,True
10881,227,34,2,0,20,15,18,15,True,True
10882,227,35,0,2,22,12,22,10,True,True
10883,227,36,0,1,11,14,11,13,True,True
10884,227,37,2,2,21,23,19,21,True,True
10885,227,38,0,2,29,20,29,18,True,True
10886,227,39,1,0,41,13,40,13,True,True
10887,227,40,1,1,54,22,53,21,True,True
10888,227,41,3,0,31,15,28,15,True,True
10889,227,42,2,2,43,23,41,21,True,True
10890,227,43,5,0,61,20,56,20,True,True
10891,227,44,4,1,72,25,68,24,True,True
10892,227,45,4,1,74,26,70,25,True,True
10893,227,46,4,2,80,45,76,43,True,True
10894,227,47,7,1,120,32,113,31,True,True
10895,227,48,5,3,115,58,110,55,True,True
10896,228,1,47,63,396,207,349,144,True,True
10897,228,2,39,54,384,249,345,195,True,True
10898,228,3,43,43,407,316,364,273,True,True
10899,228,4,35,57,323,283,288,226,True,True
10900,228,5,22,57,240,303,218,246,True,True
10901,228,6,10,43,205,279,195,236,True,True
10902,228,7,8,30,160,274,152,244,True,True
10903,228,8,9,26,149,228,140,202,True,True
10904,228,9,17,46,131,233,114,187,True,True
10905,228,10,11,27,119,191,108,164,True,True
10906,228,11,7,11,71,104,64,93,True,True
10907,228,12,9,14,51,73,42,59,True,True
10908,228,13,23,13,48,52,25,39,True,True
10909,228,14,28,10,53,41,25,31,True,True
10910,228,15,18,8,43,32,25,24,True,True
10911,228,16,36,7,34,25,-2,18,False,True
10912,228,17,30,11,46,32,16,21,True,True
10913,228,18,23,14,68,25,45,11,True,True
10914,228,19,27,7,78,23,51,16,True,True
10915,228,20,20,11,59,25,39,14,True,True
10916,228,21,18,14,71,27,53,13,True,True
10917,228,22,13,21,63,30,50,9,True,True
10918,228,23,12,13,50,34,38,21,True,True
10919,228,24,11,9,50,30,39,21,True,True
10920,228,25,7,10,54,35,47,25,True,True
10921,228,26,15,9,71,36,56,27,True,True
10922,228,27,5,8,55,35,50,27,True,True
10923,228,28,2,4,65,30,63,26,True,True
10924,228,29,5,7,63,26,58,19,True,True
10925,228,30,10,4,51,42,41,38,True,True
10926,228,31,13,18,56,45,43,27,True,True
10927,228,32,9,11,53,45,44,34,True,True
10928,228,33,6,9,56,48,50,39,True,True
10929,228,34,11,8,56,39,45,31,True,True
10930,228,35,9,6,51,44,42,38,True,True
10931,228,36,21,18,54,43,33,25,True,True
10932,228,37,15,20,80,56,65,36,True,True
10933,228,38,7,11,83,72,76,61,True,True
10934,228,39,15,14,120,54,105,40,True,True
10935,228,40,22,17,115,58,93,41,True,True
10936,228,41,16,15,161,68,145,53,True,True
10937,228,42,18,11,172,83,154,72,True,True
10938,228,43,18,12,184,74,166,62,True,True
10939,228,44,17,11,240,91,223,80,True,True
10940,228,45,28,16,262,106,234,90,True,True
10941,228,46,35,27,314,121,279,94,True,True
10942,228,47,33,26,332,142,299,116,True,True
10943,228,48,39,33,384,183,345,150,True,True
10944,229,1,3349,2851,3028,2462,-321,-389,False,False
10945,229,2,2537,2872,2269,2415,-268,-457,False,False
10946,229,3,1874,2616,1660,2209,-214,-407,False,False
10947,229,4,1591,2480,1228,2046,-363,-434,False,False
10948,229,5,1279,2257,931,1911,-348,-346,False,False
10949,229,6,996,1847,694,1702,-302,-145,False,False
10950,229,7,857,1517,523,1454,-334,-63,False,False
10951,229,8,569,1228,383,1138,-186,-90,False,False
10952,229,9,674,986,400,908,-274,-78,False,False
10953,229,10,590,626,263,523,-327,-103,False,False
10954,229,11,661,408,252,315,-409,-93,False,False
10955,229,12,1209,379,469,217,-740,-162,False,False
10956,229,13,1687,350,919,199,-768,-151,False,False
10957,229,14,3148,453,1387,234,-1761,-219,False,False
10958,229,15,4366,599,1950,308,-2416,-291,False,False
10959,229,16,6132,709,2966,360,-3166,-349,False,False
10960,229,17,6907,897,3107,400,-3800,-497,False,False
10961,229,18,7921,1135,3672,618,-4249,-517,False,False
10962,229,19,6730,1311,3807,730,-2923,-581,False,False
10963,229,20,6050,1686,3859,891,-2191,-795,False,False
10964,229,21,4839,1814,3650,1133,-1189,-681,False,False
10965,229,22,4921,2075,3829,1304,-1092,-771,False,False
10966,229,23,4448,2079,3777,1461,-671,-618,False,False
10967,229,24,4703,2359,3852,1517,-851,-842,False,False
10968,229,25,4440,2118,3868,1610,-572,-508,False,False
10969,229,26,4040,2179,3758,1633,-282,-546,False,False
10970,229,27,3749,2083,3389,1613,-360,-470,False,False
10971,229,28,3869,1987,3409,1574,-460,-413,False,False
10972,229,29,4134,1994,3654,1560,-480,-434,False,False
10973,229,30,4204,1874,3965,1615,-239,-259,False,False
10974,229,31,3811,1852,3848,1701,37,-151,True,False
10975,229,32,3344,1809,3690,1662,346,-147,True,False
10976,229,33,2949,1644,3290,1671,341,27,True,True
10977,229,34,2799,1639,2770,1668,-29,29,False,True
10978,229,35,3893,1772,3072,1657,-821,-115,False,False
10979,229,36,5354,2065,4125,1938,-1229,-127,False,False
10980,229,37,6490,2088,5169,2173,-1321,85,False,True
10981,229,38,7030,2314,6099,2381,-931,67,False,True
10982,229,39,6990,2461,6426,2345,-564,-116,False,False
10983,229,40,6998,2209,6652,2324,-346,115,False,True
10984,229,41,6420,2037,6399,2311,-21,274,False,True
10985,229,42,6320,1894,5770,2181,-550,287,False,True
10986,229,43,6865,1986,6042,2348,-823,362,False,True
10987,229,44,7009,1910,6246,2365,-763,455,False,True
10988,229,45,7236,2085,6437,2463,-799,378,False,True
10989,229,46,6542,2120,5966,2461,-576,341,False,True
10990,229,47,5746,2083,5356,2273,-390,190,False,True
10991,229,48,4984,1926,4257,2050,-727,124,False,True
10992,230,1,8081,4753,4640,3248,-3441,-1505,False,False
10993,230,2,6702,4435,3589,3000,-3113,-1435,False,False
10994,230,3,5080,4048,2829,2825,-2251,-1223,False,False
10995,230,4,4170,3498,2165,2490,-2005,-1008,False,False
10996,230,5,3240,3077,1664,2264,-1576,-813,False,False
10997,230,6,2458,2730,1313,2014,-1145,-716,False,False
10998,230,7,1808,2370,1093,1774,-715,-596,False,False
10999,230,8,1702,2130,879,1546,-823,-584,False,False
11000,230,9,2142,2248,953,1380,-1189,-868,False,False
11001,230,10,1398,1558,789,795,-609,-763,False,False
11002,230,11,1246,991,1070,458,-176,-533,False,False
11003,230,12,1362,715,2542,386,1180,-329,True,False
11004,230,13,1886,695,5544,424,3658,-271,True,False
11005,230,14,2707,740,11043,607,8336,-133,True,False
11006,230,15,3659,898,13519,773,9860,-125,True,False
11007,230,16,5105,1171,12728,1244,7623,73,True,True
11008,230,17,5860,1330,11893,1237,6033,-93,True,False
11009,230,18,6393,1713,11436,1344,5043,-369,True,False
11010,230,19,6940,2191,11073,1436,4133,-755,True,False
11011,230,20,7289,2666,11147,1896,3858,-770,True,False
11012,230,21,6991,2976,9748,2028,2757,-948,True,False
11013,230,22,7232,3183,8284,2231,1052,-952,True,False
11014,230,23,7176,3277,7881,2552,705,-725,True,False
11015,230,24,7588,3406,8030,2905,442,-501,True,False
11016,230,25,7926,3208,8300,3361,374,153,True,True
11017,230,26,7464,3133,8366,3542,902,409,True,True
11018,230,27,7261,3173,8158,4512,897,1339,True,True
11019,230,28,7904,3156,8890,5413,986,2257,True,True
11020,230,29,7925,3026,8389,4694,464,1668,True,True
11021,230,30,7524,2956,8189,5074,665,2118,True,True
11022,230,31,7362,3008,7420,3637,58,629,True,True
11023,230,32,6674,2873,7019,3297,345,424,True,True
11024,230,33,5719,2701,6129,3078,410,377,True,True
11025,230,34,4899,2792,5435,2921,536,129,True,True
11026,230,35,5515,2879,5699,3215,184,336,True,True
11027,230,36,7086,3779,6989,3984,-97,205,False,True
11028,230,37,9028,3918,8415,4405,-613,487,False,True
11029,230,38,10221,3788,10093,4404,-128,616,False,True
11030,230,39,11095,3933,10534,5426,-561,1493,False,True
11031,230,40,11597,3876,11756,6460,159,2584,True,True
11032,230,41,10817,3328,8154,3913,-2663,585,False,True
11033,230,42,9933,3098,6769,3475,-3164,377,False,True
11034,230,43,9700,3393,6887,3575,-2813,182,False,True
11035,230,44,9320,3855,7074,3659,-2246,-196,False,False
11036,230,45,9890,4069,7377,3754,-2513,-315,False,False
11037,230,46,10952,4756,7032,3637,-3920,-1119,False,False
11038,230,47,10955,4504,6741,3542,-4214,-962,False,False
11039,230,48,10163,4178,5913,3409,-4250,-769,False,False
11040,231,1,3802,3005,2841,2340,-961,-665,False,False
11041,231,2,3041,2990,2406,2286,-635,-704,False,False
11042,231,3,2266,2750,1804,2155,-462,-595,False,False
11043,231,4,1669,2464,1365,1958,-304,-506,False,False
11044,231,5,1285,2276,1070,1737,-215,-539,False,False
11045,231,6,1031,1992,866,1494,-165,-498,False,False
11046,231,7,769,1573,623,1396,-146,-177,False,False
11047,231,8,615,1254,477,1178,-138,-76,False,False
11048,231,9,632,1062,451,942,-181,-120,False,False
11049,231,10,520,609,462,603,-58,-6,False,False
11050,231,11,590,430,464,349,-126,-81,False,False
11051,231,12,1019,325,1153,245,134,-80,True,False
11052,231,13,1636,341,2147,238,511,-103,True,False
11053,231,14,3588,401,4456,252,868,-149,True,False
11054,231,15,4267,492,4907,325,640,-167,True,False
11055,231,16,5021,601,5721,454,700,-147,True,False
11056,231,17,5719,692,5837,569,118,-123,True,False
11057,231,18,5985,964,7085,846,1100,-118,True,False
11058,231,19,5828,1147,7584,1000,1756,-147,True,False
11059,231,20,5439,1450,6777,1317,1338,-133,True,False
11060,231,21,4699,1464,5637,1398,938,-66,True,False
11061,231,22,4471,1781,4751,1619,280,-162,True,False
11062,231,23,4423,1881,4207,1747,-216,-134,False,False
11063,231,24,4699,2111,4253,1799,-446,-312,False,False
11064,231,25,4750,2199,4493,1910,-257,-289,False,False
11065,231,26,4281,2160,4355,1961,74,-199,True,False
11066,231,27,4396,2107,4031,1839,-365,-268,False,False
11067,231,28,4391,2165,4083,1782,-308,-383,False,False
11068,231,29,4418,2060,4009,1743,-409,-317,False,False
11069,231,30,4361,2061,3776,1675,-585,-386,False,False
11070,231,31,4054,1942,3703,1597,-351,-345,False,False
11071,231,32,3446,1818,3131,1562,-315,-256,False,False
11072,231,33,2981,1588,2787,1473,-194,-115,False,False
11073,231,34,2990,1636,2510,1370,-480,-266,False,False
11074,231,35,3648,1846,2531,1454,-1117,-392,False,False
11075,231,36,4778,2139,3236,1837,-1542,-302,False,False
11076,231,37,5416,2186,3968,2186,-1448,0,False,False
11077,231,38,6007,2217,4958,2289,-1049,72,False,True
11078,231,39,6701,2482,5757,2372,-944,-110,False,False
11079,231,40,6792,2481,5838,2340,-954,-141,False,False
11080,231,41,6836,2419,5680,2320,-1156,-99,False,False
11081,231,42,6813,2424,5617,2279,-1196,-145,False,False
11082,231,43,7040,2332,5691,2158,-1349,-174,False,False
11083,231,44,7071,2394,5421,2088,-1650,-306,False,False
11084,231,45,7174,2541,5261,1958,-1913,-583,False,False
11085,231,46,6723,2483,4921,2073,-1802,-410,False,False
11086,231,47,6172,2470,4681,2047,-1491,-423,False,False
11087,231,48,5163,2171,4120,1917,-1043,-254,False,False
11088,232,1,542,685,1219,1056,677,371,True,True
11089,232,2,452,694,1139,1084,687,390,True,True
11090,232,3,402,830,884,965,482,135,True,True
11091,232,4,344,824,660,804,316,-20,True,False
11092,232,5,236,756,509,771,273,15,True,True
11093,232,6,193,736,449,708,256,-28,True,False
11094,232,7,132,607,405,640,273,33,True,True
11095,232,8,144,472,322,560,178,88,True,True
11096,232,9,121,367,291,520,170,153,True,True
11097,232,10,107,172,198,409,91,237,True,True
11098,232,11,82,129,143,254,61,125,True,True
11099,232,12,148,88,111,179,-37,91,False,True
11100,232,13,164,81,128,143,-36,62,False,True
11101,232,14,250,81,197,154,-53,73,False,True
11102,232,15,226,95,281,168,55,73,True,True
11103,232,16,391,105,528,314,137,209,True,True
11104,232,17,417,126,644,236,227,110,True,True
11105,232,18,488,157,554,217,66,60,True,True
11106,232,19,394,169,438,294,44,125,True,True
11107,232,20,369,191,430,285,61,94,True,True
11108,232,21,305,233,410,292,105,59,True,True
11109,232,22,275,248,430,310,155,62,True,True
11110,232,23,287,245,492,311,205,66,True,True
11111,232,24,266,256,514,367,248,111,True,True
11112,232,25,291,268,537,428,246,160,True,True
11113,232,26,239,225,495,411,256,186,True,True
11114,232,27,298,224,549,363,251,139,True,True
11115,232,28,231,227,557,371,326,144,True,True
11116,232,29,246,242,557,453,311,211,True,True
11117,232,30,273,238,741,422,468,184,True,True
11118,232,31,289,262,732,373,443,111,True,True
11119,232,32,258,211,674,413,416,202,True,True
11120,232,33,225,196,656,386,431,190,True,True
11121,232,34,200,197,632,360,432,163,True,True
11122,232,35,249,207,784,373,535,166,True,True
11123,232,36,354,247,984,458,630,211,True,True
11124,232,37,433,238,1158,494,725,256,True,True
11125,232,38,453,286,1358,504,905,218,True,True
11126,232,39,452,280,1489,588,1037,308,True,True
11127,232,40,537,237,1596,544,1059,307,True,True
11128,232,41,544,190,1573,521,1029,331,True,True
11129,232,42,616,242,1569,584,953,342,True,True
11130,232,43,647,254,1591,616,944,362,True,True
11131,232,44,657,281,1575,684,918,403,True,True
11132,232,45,738,325,1478,793,740,468,True,True
11133,232,46,718,344,1462,747,744,403,True,True
11134,232,47,749,399,1640,891,891,492,True,True
11135,232,48,749,402,1477,951,728,549,True,True
11136,233,1,1853,1889,2361,1715,508,-174,True,False
11137,233,2,1228,1608,1838,1701,610,93,True,True
11138,233,3,831,1183,1341,1666,510,483,True,True
11139,233,4,695,1022,1013,1666,318,644,True,True
11140,233,5,548,899,832,1558,284,659,True,True
11141,233,6,407,678,655,1580,248,902,True,True
11142,233,7,311,564,512,1332,201,768,True,True
11143,233,8,290,481,343,1165,53,684,True,True
11144,233,9,342,422,342,847,0,425,False,True
11145,233,10,411,358,329,520,-82,162,False,True
11146,233,11,543,316,271,325,-272,9,False,True
11147,233,12,876,258,558,223,-318,-35,False,False
11148,233,13,1379,326,1027,196,-352,-130,False,False
11149,233,14,2332,388,1780,274,-552,-114,False,False
11150,233,15,3249,506,2495,289,-754,-217,False,False
11151,233,16,4144,660,3616,445,-528,-215,False,False
11152,233,17,4675,690,4491,393,-184,-297,False,False
11153,233,18,4824,891,5389,615,565,-276,True,False
11154,233,19,4434,1051,5689,636,1255,-415,True,False
11155,233,20,4068,1457,5793,854,1725,-603,True,False
11156,233,21,3557,1585,5104,1021,1547,-564,True,False
11157,233,22,3908,1741,4340,1030,432,-711,True,False
11158,233,23,3946,1724,3864,1062,-82,-662,False,False
11159,233,24,4109,1819,3783,1285,-326,-534,False,False
11160,233,25,3981,1741,3422,1320,-559,-421,False,False
11161,233,26,3359,1762,3248,1419,-111,-343,False,False
11162,233,27,3396,1683,3030,1416,-366,-267,False,False
11163,233,28,3389,1499,3124,1407,-265,-92,False,False
11164,233,29,3544,1488,3705,1558,161,70,True,True
11165,233,30,3803,1471,3846,1537,43,66,True,True
11166,233,31,3801,1520,3581,1634,-220,114,False,True
11167,233,32,3502,1424,3363,1592,-139,168,False,True
11168,233,33,2839,1221,2741,1446,-98,225,False,True
11169,233,34,2537,1224,2359,1191,-178,-33,False,False
11170,233,35,3307,1360,2461,1398,-846,38,False,True
11171,233,36,4534,1524,3174,1589,-1360,65,False,True
11172,233,37,5415,1722,3720,1751,-1695,29,False,True
11173,233,38,5689,2049,4101,1737,-1588,-312,False,False
11174,233,39,5808,1895,4336,1660,-1472,-235,False,False
11175,233,40,5574,1821,4184,1631,-1390,-190,False,False
11176,233,41,4838,1612,3818,1600,-1020,-12,False,False
11177,233,42,4510,1683,3896,1651,-614,-32,False,False
11178,233,43,4747,1522,4235,1552,-512,30,False,True
11179,233,44,4353,1475,4354,1723,1,248,True,True
11180,233,45,4341,1474,4513,1831,172,357,True,True
11181,233,46,3820,1521,4310,1953,490,432,True,True
11182,233,47,3230,1567,3948,1734,718,167,True,True
11183,233,48,2728,1358,3332,1546,604,188,True,True
11184,234,1,6319,5344,3288,3524,-3031,-1820,False,False
11185,234,2,5423,5238,2502,3340,-2921,-1898,False,False
11186,234,3,4012,4930,1901,3011,-2111,-1919,False,False
11187,234,4,3056,4648,1447,2631,-1609,-2017,False,False
11188,234,5,2283,4211,1097,2361,-1186,-1850,False,False
11189,234,6,1693,3586,827,1942,-866,-1644,False,False
11190,234,7,1130,3001,672,1617,-458,-1384,False,False
11191,234,8,899,2350,510,1251,-389,-1099,False,False
11192,234,9,791,1703,495,1018,-296,-685,False,False
11193,234,10,626,987,390,611,-236,-376,False,False
11194,234,11,686,725,454,387,-232,-338,False,False
11195,234,12,986,555,1555,354,569,-201,True,False
11196,234,13,1594,415,1909,316,315,-99,True,False
11197,234,14,3358,463,4236,436,878,-27,True,False
11198,234,15,4102,481,5092,472,990,-9,True,False
11199,234,16,5467,672,6892,695,1425,23,True,True
11200,234,17,6337,771,7927,892,1590,121,True,True
11201,234,18,7669,1096,10475,1309,2806,213,True,True
11202,234,19,7764,1331,12344,1519,4580,188,True,True
11203,234,20,8056,1766,12643,1919,4587,153,True,True
11204,234,21,6907,1998,11408,2247,4501,249,True,True
11205,234,22,7508,2457,9704,2680,2196,223,True,True
11206,234,23,7293,2671,8995,3006,1702,335,True,True
11207,234,24,8182,2965,8900,3311,718,346,True,True
11208,234,25,8310,3106,9339,3447,1029,341,True,True
11209,234,26,8009,3309,9214,3430,1205,121,True,True
11210,234,27,7813,3334,8583,3468,770,134,True,True
11211,234,28,8525,3377,8250,3280,-275,-97,False,False
11212,234,29,8740,3407,8161,3157,-579,-250,False,False
11213,234,30,8394,3352,7898,3218,-496,-134,False,False
11214,234,31,8026,3433,7271,2972,-755,-461,False,False
11215,234,32,7295,3396,6949,2912,-346,-484,False,False
11216,234,33,6370,2977,6010,2788,-360,-189,False,False
11217,234,34,5654,2518,5159,2531,-495,13,False,True
11218,234,35,6930,2630,4965,2487,-1965,-143,False,False
11219,234,36,8114,3503,6168,3021,-1946,-482,False,False
11220,234,37,9338,3601,7449,3324,-1889,-277,False,False
11221,234,38,10635,3607,8543,3691,-2092,84,False,True
11222,234,39,11781,3595,9388,3768,-2393,173,False,True
11223,234,40,12221,3684,9953,4071,-2268,387,False,True
11224,234,41,12285,3526,9613,3776,-2672,250,False,True
11225,234,42,12225,3653,8966,3665,-3259,12,False,True
11226,234,43,11862,3740,8100,3288,-3762,-452,False,False
11227,234,44,10636,3660,7292,3175,-3344,-485,False,False
11228,234,45,9420,3833,6528,2975,-2892,-858,False,False
11229,234,46,9174,4015,5935,2879,-3239,-1136,False,False
11230,234,47,9354,4080,5370,3053,-3984,-1027,False,False
11231,234,48,8843,3802,4909,2929,-3934,-873,False,False
11232,235,1,1,4,52,41,51,37,True,True
11233,235,2,1,4,55,40,54,36,True,True
11234,235,3,3,4,35,32,32,28,True,True
11235,235,4,2,4,40,29,38,25,True,True
11236,235,5,3,1,36,39,33,38,True,True
11237,235,6,1,3,28,36,27,33,True,True
11238,235,7,2,6,22,36,20,30,True,True
11239,235,8,1,7,20,41,19,34,True,True
11240,235,9,3,5,26,49,23,44,True,True
11241,235,10,3,6,22,43,19,37,True,True
11242,235,11,0,5,10,31,10,26,True,True
11243,235,12,2,2,12,15,10,13,True,True
11244,235,13,3,0,14,12,11,12,True,True
11245,235,14,6,1,11,2,5,1,True,True
11246,235,15,2,0,16,9,14,9,True,True
11247,235,16,6,1,20,12,14,11,True,True
11248,235,17,5,1,23,10,18,9,True,True
11249,235,18,9,1,21,8,12,7,True,True
11250,235,19,7,0,16,4,9,4,True,True
11251,235,20,4,0,12,12,8,12,True,True
11252,235,21,4,0,11,8,7,8,True,True
11253,235,22,6,0,16,9,10,9,True,True
11254,235,23,1,1,17,14,16,13,True,True
11255,235,24,0,2,22,7,22,5,True,True
11256,235,25,2,1,10,8,8,7,True,True
11257,235,26,1,0,9,5,8,5,True,True
11258,235,27,2,0,11,15,9,15,True,True
11259,235,28,3,0,20,9,17,9,True,True
11260,235,29,0,0,19,5,19,5,True,True
11261,235,30,1,1,15,7,14,6,True,True
11262,235,31,2,4,12,8,10,4,True,True
11263,235,32,3,2,13,9,10,7,True,True
11264,235,33,0,0,13,5,13,5,True,True
11265,235,34,0,3,11,8,11,5,True,True
11266,235,35,2,0,12,5,10,5,True,True
11267,235,36,6,4,16,3,10,-1,True,False
11268,235,37,2,1,13,7,11,6,True,True
11269,235,38,0,0,20,15,20,15,True,True
11270,235,39,0,0,17,13,17,13,True,True
11271,235,40,0,1,29,6,29,5,True,True
11272,235,41,3,1,32,18,29,17,True,True
11273,235,42,3,0,37,15,34,15,True,True
11274,235,43,9,1,42,14,33,13,True,True
11275,235,44,4,1,32,15,28,14,True,True
11276,235,45,0,2,42,23,42,21,True,True
11277,235,46,1,0,46,20,45,20,True,True
11278,235,47,2,2,48,20,46,18,True,True
11279,235,48,2,2,61,29,59,27,True,True
11280,236,1,2138,1718,3546,2149,1408,431,True,True
11281,236,2,1472,1470,2793,2073,1321,603,True,True
11282,236,3,1029,1157,1938,1863,909,706,True,True
11283,236,4,651,777,1385,1819,734,1042,True,True
11284,236,5,460,610,1006,1755,546,1145,True,True
11285,236,6,389,486,881,1548,492,1062,True,True
11286,236,7,282,406,595,1375,313,969,True,True
11287,236,8,258,326,489,1071,231,745,True,True
11288,236,9,323,301,395,926,72,625,True,True
11289,236,10,490,234,335,526,-155,292,False,True
11290,236,11,849,246,378,345,-471,99,False,True
11291,236,12,1750,317,1078,277,-672,-40,False,False
11292,236,13,2879,417,1603,328,-1276,-89,False,False
11293,236,14,6150,729,2882,547,-3268,-182,False,False
11294,236,15,8590,965,4559,685,-4031,-280,False,False
11295,236,16,11793,1281,6725,1224,-5068,-57,False,False
11296,236,17,13677,1364,9774,1252,-3903,-112,False,False
11297,236,18,12790,1946,8523,1746,-4267,-200,False,False
11298,236,19,11937,2296,8265,2181,-3672,-115,False,False
11299,236,20,10924,2723,8342,2677,-2582,-46,False,False
11300,236,21,10401,2942,9227,2965,-1174,23,False,True
11301,236,22,10444,3381,9927,3501,-517,120,False,True
11302,236,23,10171,3428,10162,3500,-9,72,False,True
11303,236,24,10863,3534,10724,3275,-139,-259,False,False
11304,236,25,11283,3946,11101,3469,-182,-477,False,False
11305,236,26,10546,3720,10809,3532,263,-188,True,False
11306,236,27,9919,3789,10667,3481,748,-308,True,False
11307,236,28,9985,3588,10659,3425,674,-163,True,False
11308,236,29,10323,3466,10592,3256,269,-210,True,False
11309,236,30,10916,3372,11251,3347,335,-25,True,False
11310,236,31,11298,3427,11337,3555,39,128,True,True
11311,236,32,10518,3508,10644,3419,126,-89,True,False
11312,236,33,9005,3339,9390,3365,385,26,True,True
11313,236,34,8186,3010,8233,3018,47,8,True,True
11314,236,35,9801,3325,8556,2883,-1245,-442,False,False
11315,236,36,11166,3558,10400,3309,-766,-249,False,False
11316,236,37,11673,3332,11709,3573,36,241,True,True
11317,236,38,12269,3516,12272,3362,3,-154,True,False
11318,236,39,11079,3434,11968,3369,889,-65,True,False
11319,236,40,9561,3045,11358,2944,1797,-101,True,False
11320,236,41,8238,2583,10238,2727,2000,144,True,True
11321,236,42,7419,2512,8904,2583,1485,71,True,True
11322,236,43,7450,2381,8853,2615,1403,234,True,True
11323,236,44,6681,2249,8945,2605,2264,356,True,True
11324,236,45,6077,2169,8494,2672,2417,503,True,True
11325,236,46,4853,1987,7618,2500,2765,513,True,True
11326,236,47,3949,1797,6390,2328,2441,531,True,True
11327,236,48,3177,1582,5011,1895,1834,313,True,True
11328,237,1,3159,2213,2581,1497,-578,-716,False,False
11329,237,2,2268,1748,1901,1359,-367,-389,False,False
11330,237,3,1512,1417,1337,1239,-175,-178,False,False
11331,237,4,965,995,982,1074,17,79,True,True
11332,237,5,674,731,737,1002,63,271,True,True
11333,237,6,551,528,537,908,-14,380,False,True
11334,237,7,391,435,410,746,19,311,True,True
11335,237,8,320,335,379,606,59,271,True,True
11336,237,9,349,322,297,502,-52,180,False,True
11337,237,10,509,253,382,322,-127,69,False,True
11338,237,11,662,226,492,217,-170,-9,False,False
11339,237,12,1376,261,1406,213,30,-48,True,False
11340,237,13,2180,374,1734,263,-446,-111,False,False
11341,237,14,4437,580,3539,522,-898,-58,False,False
11342,237,15,6170,660,4807,731,-1363,71,False,True
11343,237,16,10174,1022,7439,1019,-2735,-3,False,False
11344,237,17,12229,1117,8442,1191,-3787,74,False,True
11345,237,18,13653,1656,10034,1746,-3619,90,False,True
11346,237,19,12787,1827,10628,2205,-2159,378,False,True
11347,237,20,11471,2374,10723,2797,-748,423,False,True
11348,237,21,10556,2530,11253,3315,697,785,True,True
11349,237,22,10916,3011,11697,3812,781,801,True,True
11350,237,23,10704,3041,11793,3770,1089,729,True,True
11351,237,24,11844,3614,12662,3804,818,190,True,True
11352,237,25,12335,3729,13347,4053,1012,324,True,True
11353,237,26,12157,4068,13443,4261,1286,193,True,True
11354,237,27,12304,4100,12290,4188,-14,88,False,True
11355,237,28,12161,4207,11424,4007,-737,-200,False,False
11356,237,29,12675,4147,11296,3705,-1379,-442,False,False
11357,237,30,12759,4135,11688,3818,-1071,-317,False,False
11358,237,31,12178,4214,11193,3839,-985,-375,False,False
11359,237,32,10648,4289,10581,3788,-67,-501,False,False
11360,237,33,9277,3941,9067,3490,-210,-451,False,False
11361,237,34,8293,3680,7787,3070,-506,-610,False,False
11362,237,35,10823,3959,7862,2950,-2961,-1009,False,False
11363,237,36,13083,4388,9405,3367,-3678,-1021,False,False
11364,237,37,14626,4247,10847,3393,-3779,-854,False,False
11365,237,38,14244,3860,11728,3341,-2516,-519,False,False
11366,237,39,13801,3756,11183,3288,-2618,-468,False,False
11367,237,40,11847,3327,9949,2928,-1898,-399,False,False
11368,237,41,11206,2953,8539,2556,-2667,-397,False,False
11369,237,42,10187,2687,7105,2211,-3082,-476,False,False
11370,237,43,10070,2687,6693,2242,-3377,-445,False,False
11371,237,44,9472,2519,6719,2093,-2753,-426,False,False
11372,237,45,8806,2376,6478,1938,-2328,-438,False,False
11373,237,46,7275,2311,5511,1845,-1764,-466,False,False
11374,237,47,5919,2078,4589,1752,-1330,-326,False,False
11375,237,48,4451,1836,3719,1498,-732,-338,False,False
11376,238,1,1590,1435,3220,1901,1630,466,True,True
11377,238,2,1142,1268,2518,2049,1376,781,True,True
11378,238,3,899,1010,1844,1789,945,779,True,True
11379,238,4,656,886,1381,1665,725,779,True,True
11380,238,5,465,721,1007,1553,542,832,True,True
11381,238,6,399,598,743,1392,344,794,True,True
11382,238,7,298,527,606,1228,308,701,True,True
11383,238,8,301,426,496,993,195,567,True,True
11384,238,9,331,310,399,817,68,507,True,True
11385,238,10,505,301,312,579,-193,278,False,True
11386,238,11,735,297,265,353,-470,56,False,True
11387,238,12,1258,298,423,261,-835,-37,False,False
11388,238,13,1874,425,563,257,-1311,-168,False,False
11389,238,14,3161,620,822,267,-2339,-353,False,False
11390,238,15,3976,689,1322,316,-2654,-373,False,False
11391,238,16,4524,1038,2318,453,-2206,-585,False,False
11392,238,17,5077,1173,3408,568,-1669,-605,False,False
11393,238,18,4515,1528,3216,785,-1299,-743,False,False
11394,238,19,3783,1767,2546,1073,-1237,-694,False,False
11395,238,20,3817,2169,2531,1271,-1286,-898,False,False
11396,238,21,4339,2260,2704,1471,-1635,-789,False,False
11397,238,22,4665,2432,3021,1603,-1644,-829,False,False
11398,238,23,4260,2248,3275,1601,-985,-647,False,False
11399,238,24,4601,2300,3630,1657,-971,-643,False,False
11400,238,25,4604,2301,3789,1797,-815,-504,False,False
11401,238,26,4530,2368,3803,1849,-727,-519,False,False
11402,238,27,4102,2252,3724,1785,-378,-467,False,False
11403,238,28,4120,2186,3935,1815,-185,-371,False,False
11404,238,29,3950,2085,4312,1822,362,-263,True,False
11405,238,30,4351,2067,4919,1938,568,-129,True,False
11406,238,31,4871,1899,5121,1972,250,73,True,True
11407,238,32,4264,1941,4804,1971,540,30,True,True
11408,238,33,3834,1779,4316,1938,482,159,True,True
11409,238,34,3505,1739,4099,1817,594,78,True,True
11410,238,35,4265,1785,4496,1819,231,34,True,True
11411,238,36,5055,1975,5551,1979,496,4,True,True
11412,238,37,5594,2095,6269,2249,675,154,True,True
11413,238,38,5940,2120,6852,2179,912,59,True,True
11414,238,39,5624,2181,6945,2116,1321,-65,True,False
11415,238,40,4871,1974,6778,1831,1907,-143,True,False
11416,238,41,4339,1732,6437,1842,2098,110,True,True
11417,238,42,3698,1580,6161,1787,2463,207,True,True
11418,238,43,3747,1593,6269,1906,2522,313,True,True
11419,238,44,3754,1668,6408,2043,2654,375,True,True
11420,238,45,3500,1569,6320,2051,2820,482,True,True
11421,238,46,3094,1577,5615,1961,2521,384,True,True
11422,238,47,2710,1427,5017,2024,2307,597,True,True
11423,238,48,2210,1323,4197,1897,1987,574,True,True
11424,239,1,2766,2616,3372,2197,606,-419,True,False
11425,239,2,1838,2248,2628,2168,790,-80,True,False
11426,239,3,1479,2009,1810,1957,331,-52,True,False
11427,239,4,1020,1549,1302,1768,282,219,True,True
11428,239,5,758,1399,996,1626,238,227,True,True
11429,239,6,639,1041,777,1396,138,355,True,True
11430,239,7,446,756,561,1158,115,402,True,True
11431,239,8,402,613,413,911,11,298,True,True
11432,239,9,432,596,388,774,-44,178,False,True
11433,239,10,579,362,272,452,-307,90,False,True
11434,239,11,775,335,289,289,-486,-46,False,False
11435,239,12,1399,321,556,208,-843,-113,False,False
11436,239,13,2127,411,844,228,-1283,-183,False,False
11437,239,14,3613,567,1175,308,-2438,-259,False,False
11438,239,15,4896,791,1789,476,-3107,-315,False,False
11439,239,16,5345,1042,2565,675,-2780,-367,False,False
11440,239,17,5658,1281,3589,974,-2069,-307,False,False
11441,239,18,4745,1698,3218,1241,-1527,-457,False,False
11442,239,19,4637,1906,3339,1816,-1298,-90,False,False
11443,239,20,5135,2441,3427,2030,-1708,-411,False,False
11444,239,21,5681,2488,4237,2392,-1444,-96,False,False
11445,239,22,5816,2935,4428,2588,-1388,-347,False,False
11446,239,23,5566,2861,4798,2966,-768,105,False,True
11447,239,24,6147,3058,4894,2740,-1253,-318,False,False
11448,239,25,6133,3109,5372,2954,-761,-155,False,False
11449,239,26,6146,3389,5550,3092,-596,-297,False,False
11450,239,27,6045,3309,5156,3028,-889,-281,False,False
11451,239,28,6133,3275,5124,2784,-1009,-491,False,False
11452,239,29,6359,3347,5215,2793,-1144,-554,False,False
11453,239,30,6683,3396,5637,2794,-1046,-602,False,False
11454,239,31,6791,3235,6263,2879,-528,-356,False,False
11455,239,32,6550,3139,6200,2849,-350,-290,False,False
11456,239,33,5864,3056,5611,2741,-253,-315,False,False
11457,239,34,5281,2651,5023,2471,-258,-180,False,False
11458,239,35,6307,2955,5504,2456,-803,-499,False,False
11459,239,36,7364,3364,6746,2822,-618,-542,False,False
11460,239,37,7708,3249,7969,3100,261,-149,True,False
11461,239,38,8248,3380,9185,3222,937,-158,True,False
11462,239,39,7992,3299,9700,3258,1708,-41,True,False
11463,239,40,7314,3012,9397,2880,2083,-132,True,False
11464,239,41,6370,2487,8570,2718,2200,231,True,True
11465,239,42,6260,2367,7400,2412,1140,45,True,True
11466,239,43,6461,2472,7414,2328,953,-144,True,False
11467,239,44,6500,2528,7259,2481,759,-47,True,False
11468,239,45,7077,2742,6877,2374,-200,-368,False,False
11469,239,46,5622,2418,6428,2355,806,-63,True,False
11470,239,47,4733,2244,5446,2242,713,-2,True,False
11471,239,48,3930,1912,4640,2100,710,188,True,True
11472,240,1,0,0,6,7,6,7,True,True
11473,240,2,0,1,4,9,4,8,True,True
11474,240,3,1,0,12,5,11,5,True,True
11475,240,4,0,0,5,14,5,14,True,True
11476,240,5,0,2,8,12,8,10,True,True
11477,240,6,1,2,8,13,7,11,True,True
11478,240,7,2,0,7,11,5,11,True,True
11479,240,8,0,0,1,11,1,11,True,True
11480,240,9,0,0,4,9,4,9,True,True
11481,240,10,2,1,4,6,2,5,True,True
11482,240,11,0,1,4,6,4,5,True,True
11483,240,12,0,0,2,7,2,7,True,True
11484,240,13,0,1,4,12,4,11,True,True
11485,240,14,1,0,9,16,8,16,True,True
11486,240,15,2,0,7,13,5,13,True,True
11487,240,16,3,0,4,12,1,12,True,True
11488,240,17,0,0,3,5,3,5,True,True
11489,240,18,0,0,8,5,8,5,True,True
11490,240,19,0,0,8,8,8,8,True,True
11491,240,20,0,0,4,7,4,7,True,True
11492,240,21,1,1,4,9,3,8,True,True
11493,240,22,0,0,2,3,2,3,True,True
11494,240,23,0,0,2,8,2,8,True,True
11495,240,24,0,0,4,3,4,3,True,True
11496,240,25,0,0,5,5,5,5,True,True
11497,240,26,0,0,3,5,3,5,True,True
11498,240,27,0,0,3,4,3,4,True,True
11499,240,28,1,0,3,5,2,5,True,True
11500,240,29,0,1,1,7,1,6,True,True
11501,240,30,0,1,3,6,3,5,True,True
11502,240,31,0,0,2,0,2,0,True,False
11503,240,32,0,1,1,3,1,2,True,True
11504,240,33,0,1,1,3,1,2,True,True
11505,240,34,0,0,1,0,1,0,True,False
11506,240,35,1,0,2,3,1,3,True,True
11507,240,36,0,0,3,1,3,1,True,True
11508,240,37,0,0,2,2,2,2,True,True
11509,240,38,0,0,5,3,5,3,True,True
11510,240,39,0,0,11,2,11,2,True,True
11511,240,40,1,0,5,2,4,2,True,True
11512,240,41,0,0,7,2,7,2,True,True
11513,240,42,0,0,5,1,5,1,True,True
11514,240,43,3,0,6,1,3,1,True,True
11515,240,44,0,0,14,2,14,2,True,True
11516,240,45,0,0,10,5,10,5,True,True
11517,240,46,0,1,12,3,12,2,True,True
11518,240,47,2,0,19,5,17,5,True,True
11519,240,48,0,1,16,6,16,5,True,True
11520,241,1,0,0,56,29,56,29,True,True
11521,241,2,3,1,82,34,79,33,True,True
11522,241,3,0,0,44,28,44,28,True,True
11523,241,4,2,0,49,33,47,33,True,True
11524,241,5,0,0,46,50,46,50,True,True
11525,241,6,2,3,29,48,27,45,True,True
11526,241,7,1,1,32,37,31,36,True,True
11527,241,8,2,1,27,38,25,37,True,True
11528,241,9,0,0,19,45,19,45,True,True
11529,241,10,1,1,32,47,31,46,True,True
11530,241,11,0,3,14,31,14,28,True,True
11531,241,12,3,4,12,21,9,17,True,True
11532,241,13,2,2,10,17,8,15,True,True
11533,241,14,0,0,5,11,5,11,True,True
11534,241,15,0,1,11,11,11,10,True,True
11535,241,16,0,2,9,8,9,6,True,True
11536,241,17,1,2,12,8,11,6,True,True
11537,241,18,1,2,9,7,8,5,True,True
11538,241,19,2,1,14,4,12,3,True,True
11539,241,20,0,0,7,11,7,11,True,True
11540,241,21,0,2,15,8,15,6,True,True
11541,241,22,0,1,12,10,12,9,True,True
11542,241,23,1,0,10,4,9,4,True,True
11543,241,24,0,0,12,5,12,5,True,True
11544,241,25,0,0,6,8,6,8,True,True
11545,241,26,0,0,11,9,11,9,True,True
11546,241,27,1,3,13,6,12,3,True,True
11547,241,28,2,0,13,8,11,8,True,True
11548,241,29,1,2,12,7,11,5,True,True
11549,241,30,2,1,20,7,18,6,True,True
11550,241,31,0,1,10,9,10,8,True,True
11551,241,32,0,0,13,1,13,1,True,True
11552,241,33,1,0,11,5,10,5,True,True
11553,241,34,4,2,8,4,4,2,True,True
11554,241,35,0,2,11,11,11,9,True,True
11555,241,36,0,0,10,12,10,12,True,True
11556,241,37,0,0,25,11,25,11,True,True
11557,241,38,0,0,18,9,18,9,True,True
11558,241,39,0,1,34,15,34,14,True,True
11559,241,40,3,0,43,15,40,15,True,True
11560,241,41,1,1,26,26,25,25,True,True
11561,241,42,1,0,47,8,46,8,True,True
11562,241,43,3,0,43,11,40,11,True,True
11563,241,44,3,0,48,16,45,16,True,True
11564,241,45,2,0,55,17,53,17,True,True
11565,241,46,1,3,72,22,71,19,True,True
11566,241,47,2,0,82,25,80,25,True,True
11567,241,48,5,1,69,22,64,21,True,True
11568,242,1,3,1,29,16,26,15,True,True
11569,242,2,2,3,28,18,26,15,True,True
11570,242,3,1,1,28,16,27,15,True,True
11571,242,4,1,2,22,20,21,18,True,True
11572,242,5,1,2,18,21,17,19,True,True
11573,242,6,1,1,16,29,15,28,True,True
11574,242,7,3,4,6,24,3,20,True,True
11575,242,8,0,1,11,15,11,14,True,True
11576,242,9,0,1,18,18,18,17,True,True
11577,242,10,1,0,10,21,9,21,True,True
11578,242,11,0,3,7,17,7,14,True,True
11579,242,12,0,0,6,10,6,10,True,True
11580,242,13,2,2,6,9,4,7,True,True
11581,242,14,0,1,6,5,6,4,True,True
11582,242,15,1,1,6,6,5,5,True,True
11583,242,16,7,0,16,4,9,4,True,True
11584,242,17,3,0,16,8,13,8,True,True
11585,242,18,0,0,10,6,10,6,True,True
11586,242,19,0,1,11,4,11,3,True,True
11587,242,20,6,0,13,5,7,5,True,True
11588,242,21,0,2,12,2,12,0,True,False
11589,242,22,0,0,14,1,14,1,True,True
11590,242,23,2,0,10,13,8,13,True,True
11591,242,24,3,1,15,4,12,3,True,True
11592,242,25,2,1,10,3,8,2,True,True
11593,242,26,0,1,10,5,10,4,True,True
11594,242,27,1,0,12,10,11,10,True,True
11595,242,28,0,0,6,5,6,5,True,True
11596,242,29,0,0,9,5,9,5,True,True
11597,242,30,4,1,13,8,9,7,True,True
11598,242,31,1,0,5,5,4,5,True,True
11599,242,32,1,0,11,3,10,3,True,True
11600,242,33,2,0,4,3,2,3,True,True
11601,242,34,2,0,9,3,7,3,True,True
11602,242,35,2,0,14,1,12,1,True,True
11603,242,36,2,0,8,1,6,1,True,True
11604,242,37,0,0,7,8,7,8,True,True
11605,242,38,0,0,11,11,11,11,True,True
11606,242,39,0,1,8,6,8,5,True,True
11607,242,40,0,0,10,5,10,5,True,True
11608,242,41,2,0,19,6,17,6,True,True
11609,242,42,2,0,28,5,26,5,True,True
11610,242,43,1,0,25,7,24,7,True,True
11611,242,44,4,1,25,7,21,6,True,True
11612,242,45,2,1,30,4,28,3,True,True
11613,242,46,4,0,27,7,23,7,True,True
11614,242,47,2,0,23,12,21,12,True,True
11615,242,48,1,1,23,10,22,9,True,True
11616,243,1,78,79,819,456,741,377,True,True
11617,243,2,76,81,743,514,667,433,True,True
11618,243,3,35,81,557,521,522,440,True,True
11619,243,4,30,50,436,485,406,435,True,True
11620,243,5,32,43,347,426,315,383,True,True
11621,243,6,25,38,278,415,253,377,True,True
11622,243,7,8,45,226,379,218,334,True,True
11623,243,8,9,29,167,276,158,247,True,True
11624,243,9,18,42,149,266,131,224,True,True
11625,243,10,13,23,132,223,119,200,True,True
11626,243,11,15,13,91,148,76,135,True,True
11627,243,12,4,6,40,100,36,94,True,True
11628,243,13,4,5,40,66,36,61,True,True
11629,243,14,12,7,75,57,63,50,True,True
11630,243,15,17,6,73,42,56,36,True,True
11631,243,16,14,5,111,38,97,33,True,True
11632,243,17,36,10,108,40,72,30,True,True
11633,243,18,32,6,139,63,107,57,True,True
11634,243,19,17,12,123,76,106,64,True,True
11635,243,20,26,11,124,71,98,60,True,True
11636,243,21,16,15,139,79,123,64,True,True
11637,243,22,12,14,134,95,122,81,True,True
11638,243,23,12,13,110,102,98,89,True,True
11639,243,24,20,11,157,97,137,86,True,True
11640,243,25,14,11,166,100,152,89,True,True
11641,243,26,20,21,144,112,124,91,True,True
11642,243,27,17,28,156,120,139,92,True,True
11643,243,28,15,33,158,125,143,92,True,True
11644,243,29,18,31,159,133,141,102,True,True
11645,243,30,16,20,203,150,187,130,True,True
11646,243,31,27,19,201,152,174,133,True,True
11647,243,32,22,20,181,143,159,123,True,True
11648,243,33,14,20,163,143,149,123,True,True
11649,243,34,16,8,150,151,134,143,True,True
11650,243,35,18,12,141,143,123,131,True,True
11651,243,36,20,18,182,150,162,132,True,True
11652,243,37,35,26,225,169,190,143,True,True
11653,243,38,35,27,303,189,268,162,True,True
11654,243,39,39,33,378,197,339,164,True,True
11655,243,40,37,16,490,180,453,164,True,True
11656,243,41,42,20,545,214,503,194,True,True
11657,243,42,51,26,620,199,569,173,True,True
11658,243,43,63,37,717,223,654,186,True,True
11659,243,44,66,39,777,286,711,247,True,True
11660,243,45,71,48,845,271,774,223,True,True
11661,243,46,89,54,943,320,854,266,True,True
11662,243,47,100,65,949,359,849,294,True,True
11663,243,48,96,63,933,400,837,337,True,True
11664,244,1,230,167,1157,615,927,448,True,True
11665,244,2,187,132,1092,730,905,598,True,True
11666,244,3,136,155,926,763,790,608,True,True
11667,244,4,98,114,791,822,693,708,True,True
11668,244,5,84,110,656,708,572,598,True,True
11669,244,6,67,108,523,731,456,623,True,True
11670,244,7,61,104,486,707,425,603,True,True
11671,244,8,42,72,374,684,332,612,True,True
11672,244,9,55,87,373,637,318,550,True,True
11673,244,10,68,59,337,512,269,453,True,True
11674,244,11,53,59,302,357,249,298,True,True
11675,244,12,63,50,304,268,241,218,True,True
11676,244,13,81,58,388,199,307,141,True,True
11677,244,14,169,48,819,296,650,248,True,True
11678,244,15,171,48,822,245,651,197,True,True
11679,244,16,285,86,795,272,510,186,True,True
11680,244,17,330,92,682,195,352,103,True,True
11681,244,18,335,106,764,156,429,50,True,True
11682,244,19,319,103,746,140,427,37,True,True
11683,244,20,288,135,647,148,359,13,True,True
11684,244,21,211,93,606,161,395,68,True,True
11685,244,22,231,86,586,157,355,71,True,True
11686,244,23,227,93,543,151,316,58,True,True
11687,244,24,248,113,530,156,282,43,True,True
11688,244,25,248,69,465,166,217,97,True,True
11689,244,26,290,82,529,166,239,84,True,True
11690,244,27,262,92,521,163,259,71,True,True
11691,244,28,242,89,490,193,248,104,True,True
11692,244,29,252,108,471,185,219,77,True,True
11693,244,30,265,109,525,173,260,64,True,True
11694,244,31,247,95,452,200,205,105,True,True
11695,244,32,214,65,420,212,206,147,True,True
11696,244,33,188,67,383,203,195,136,True,True
11697,244,34,178,84,343,194,165,110,True,True
11698,244,35,190,75,313,198,123,123,True,True
11699,244,36,192,69,334,216,142,147,True,True
11700,244,37,222,92,439,246,217,154,True,True
11701,244,38,232,85,505,289,273,204,True,True
11702,244,39,211,91,606,290,395,199,True,True
11703,244,40,254,91,669,247,415,156,True,True
11704,244,41,231,75,652,248,421,173,True,True
11705,244,42,209,79,798,294,589,215,True,True
11706,244,43,210,94,842,295,632,201,True,True
11707,244,44,225,92,933,331,708,239,True,True
11708,244,45,223,104,980,396,757,292,True,True
11709,244,46,270,131,1127,407,857,276,True,True
11710,244,47,340,159,1200,484,860,325,True,True
11711,244,48,254,142,1231,547,977,405,True,True
11712,245,1,0,0,2,3,2,3,True,True
11713,245,2,0,0,2,2,2,2,True,True
11714,245,3,0,0,3,5,3,5,True,True
11715,245,4,0,0,8,2,8,2,True,True
11716,245,5,0,0,2,4,2,4,True,True
11717,245,6,0,0,2,0,2,0,True,False
11718,245,7,0,0,1,2,1,2,True,True
11719,245,8,0,0,4,4,4,4,True,True
11720,245,9,0,0,1,2,1,2,True,True
11721,245,10,0,0,1,2,1,2,True,True
11722,245,11,0,0,1,0,1,0,True,False
11723,245,12,0,0,1,2,1,2,True,True
11724,245,13,0,0,0,2,0,2,False,True
11725,245,14,0,0,1,0,1,0,True,False
11726,245,15,0,0,0,0,0,0,False,False
11727,245,16,0,0,0,0,0,0,False,False
11728,245,17,0,1,2,2,2,1,True,True
11729,245,18,0,1,1,2,1,1,True,True
11730,245,19,0,0,3,1,3,1,True,True
11731,245,20,0,3,0,4,0,1,False,True
11732,245,21,0,2,1,3,1,1,True,True
11733,245,22,1,1,1,1,0,0,False,False
11734,245,23,1,0,1,0,0,0,False,False
11735,245,24,0,0,0,1,0,1,False,True
11736,245,25,0,0,1,2,1,2,True,True
11737,245,26,0,0,0,1,0,1,False,True
11738,245,27,0,1,0,0,0,-1,False,False
11739,245,28,0,0,0,0,0,0,False,False
11740,245,29,0,0,2,0,2,0,True,False
11741,245,30,0,0,0,0,0,0,False,False
11742,245,31,0,0,1,0,1,0,True,False
11743,245,32,0,0,0,1,0,1,False,True
11744,245,33,0,0,0,1,0,1,False,True
11745,245,34,0,0,0,0,0,0,False,False
11746,245,35,0,0,0,2,0,2,False,True
11747,245,36,0,0,3,0,3,0,True,False
11748,245,37,0,1,1,1,1,0,True,False
11749,245,38,0,0,1,0,1,0,True,False
11750,245,39,0,0,3,1,3,1,True,True
11751,245,40,0,0,1,1,1,1,True,True
11752,245,41,0,0,6,2,6,2,True,True
11753,245,42,1,0,4,1,3,1,True,True
11754,245,43,1,0,3,1,2,1,True,True
11755,245,44,0,0,5,1,5,1,True,True
11756,245,45,0,0,6,1,6,1,True,True
11757,245,46,0,0,6,1,6,1,True,True
11758,245,47,0,0,6,1,6,1,True,True
11759,245,48,0,0,7,0,7,0,True,False
11760,246,1,2147,2435,2173,2356,26,-79,True,False
11761,246,2,1796,2201,1696,2248,-100,47,False,True
11762,246,3,1494,2226,1403,1887,-91,-339,False,False
11763,246,4,1247,2218,989,1648,-258,-570,False,False
11764,246,5,1208,2287,822,1425,-386,-862,False,False
11765,246,6,1102,2151,628,1149,-474,-1002,False,False
11766,246,7,1106,2278,432,1005,-674,-1273,False,False
11767,246,8,1000,2148,335,826,-665,-1322,False,False
11768,246,9,915,1633,313,692,-602,-941,False,False
11769,246,10,478,805,279,419,-199,-386,False,False
11770,246,11,326,366,363,358,37,-8,True,False
11771,246,12,485,229,629,296,144,67,True,True
11772,246,13,903,184,1221,537,318,353,True,True
11773,246,14,1620,213,1960,735,340,522,True,True
11774,246,15,2170,259,2356,730,186,471,True,True
11775,246,16,2929,335,3406,1161,477,826,True,True
11776,246,17,3396,463,4992,1524,1596,1061,True,True
11777,246,18,4294,633,6125,2205,1831,1572,True,True
11778,246,19,4137,711,7248,2468,3111,1757,True,True
11779,246,20,3919,916,8079,3012,4160,2096,True,True
11780,246,21,3119,979,6632,2552,3513,1573,True,True
11781,246,22,3273,1271,5009,2456,1736,1185,True,True
11782,246,23,3007,1375,4515,2387,1508,1012,True,True
11783,246,24,3382,1682,4298,2564,916,882,True,True
11784,246,25,3536,1796,4179,2570,643,774,True,True
11785,246,26,3774,2023,4097,2606,323,583,True,True
11786,246,27,3426,1961,3707,2600,281,639,True,True
11787,246,28,3590,2169,3962,2624,372,455,True,True
11788,246,29,3288,2078,3942,2556,654,478,True,True
11789,246,30,3573,2230,3936,2617,363,387,True,True
11790,246,31,3137,2005,3770,2548,633,543,True,True
11791,246,32,3280,1995,3878,2544,598,549,True,True
11792,246,33,2933,1838,3303,2384,370,546,True,True
11793,246,34,2454,1689,2798,2081,344,392,True,True
11794,246,35,2855,1725,2928,2094,73,369,True,True
11795,246,36,3764,2110,4160,2585,396,475,True,True
11796,246,37,4796,2091,5311,2739,515,648,True,True
11797,246,38,5281,2165,6114,2773,833,608,True,True
11798,246,39,5503,2104,6310,2749,807,645,True,True
11799,246,40,5480,2156,6239,2618,759,462,True,True
11800,246,41,5287,1913,5618,2127,331,214,True,True
11801,246,42,5040,1941,4750,1845,-290,-96,False,False
11802,246,43,4649,2023,4209,1777,-440,-246,False,False
11803,246,44,3854,1748,3893,1673,39,-75,True,False
11804,246,45,3817,2084,3678,1751,-139,-333,False,False
11805,246,46,3542,1817,3794,1941,252,124,True,True
11806,246,47,3197,1803,3258,1879,61,76,True,True
11807,246,48,2996,1828,3162,1963,166,135,True,True
11808,247,1,20,9,97,55,77,46,True,True
11809,247,2,16,12,84,48,68,36,True,True
11810,247,3,6,12,77,54,71,42,True,True
11811,247,4,9,11,59,60,50,49,True,True
11812,247,5,6,14,45,65,39,51,True,True
11813,247,6,5,8,31,53,26,45,True,True
11814,247,7,6,9,32,65,26,56,True,True
11815,247,8,10,9,42,63,32,54,True,True
11816,247,9,9,9,28,42,19,33,True,True
11817,247,10,8,13,23,54,15,41,True,True
11818,247,11,11,14,22,37,11,23,True,True
11819,247,12,13,9,20,22,7,13,True,True
11820,247,13,13,6,24,27,11,21,True,True
11821,247,14,14,8,22,21,8,13,True,True
11822,247,15,22,6,27,29,5,23,True,True
11823,247,16,31,5,33,19,2,14,True,True
11824,247,17,36,9,67,22,31,13,True,True
11825,247,18,13,10,61,27,48,17,True,True
11826,247,19,15,6,61,31,46,25,True,True
11827,247,20,13,11,74,36,61,25,True,True
11828,247,21,13,5,64,37,51,32,True,True
11829,247,22,6,9,50,35,44,26,True,True
11830,247,23,7,8,72,59,65,51,True,True
11831,247,24,13,3,69,44,56,41,True,True
11832,247,25,16,9,87,71,71,62,True,True
11833,247,26,15,11,105,69,90,58,True,True
11834,247,27,12,5,97,68,85,63,True,True
11835,247,28,8,8,57,56,49,48,True,True
11836,247,29,8,6,48,35,40,29,True,True
11837,247,30,14,4,59,28,45,24,True,True
11838,247,31,9,7,50,34,41,27,True,True
11839,247,32,15,9,45,31,30,22,True,True
11840,247,33,12,10,35,26,23,16,True,True
11841,247,34,26,8,37,29,11,21,True,True
11842,247,35,29,15,49,34,20,19,True,True
11843,247,36,33,14,79,42,46,28,True,True
11844,247,37,19,12,137,51,118,39,True,True
11845,247,38,23,9,173,99,150,90,True,True
11846,247,39,27,13,175,87,148,74,True,True
11847,247,40,19,11,148,70,129,59,True,True
11848,247,41,10,10,107,52,97,42,True,True
11849,247,42,16,8,62,37,46,29,True,True
11850,247,43,27,11,71,34,44,23,True,True
11851,247,44,25,8,71,21,46,13,True,True
11852,247,45,34,14,73,27,39,13,True,True
11853,247,46,24,10,64,32,40,22,True,True
11854,247,47,14,12,78,41,64,29,True,True
11855,247,48,14,11,70,65,56,54,True,True
11856,248,1,0,0,16,17,16,17,True,True
11857,248,2,2,1,23,20,21,19,True,True
11858,248,3,2,1,27,23,25,22,True,True
11859,248,4,0,0,19,16,19,16,True,True
11860,248,5,2,0,21,27,19,27,True,True
11861,248,6,0,5,16,14,16,9,True,True
11862,248,7,2,1,25,25,23,24,True,True
11863,248,8,0,0,17,24,17,24,True,True
11864,248,9,0,2,15,32,15,30,True,True
11865,248,10,1,1,21,25,20,24,True,True
11866,248,11,0,0,12,18,12,18,True,True
11867,248,12,0,0,7,10,7,10,True,True
11868,248,13,1,0,5,6,4,6,True,True
11869,248,14,2,0,7,7,5,7,True,True
11870,248,15,3,0,3,4,0,4,False,True
11871,248,16,5,1,7,5,2,4,True,True
11872,248,17,2,0,12,5,10,5,True,True
11873,248,18,4,1,8,7,4,6,True,True
11874,248,19,3,0,6,3,3,3,True,True
11875,248,20,4,0,11,4,7,4,True,True
11876,248,21,3,0,6,3,3,3,True,True
11877,248,22,4,2,8,7,4,5,True,True
11878,248,23,7,1,14,11,7,10,True,True
11879,248,24,3,0,6,2,3,2,True,True
11880,248,25,5,0,10,2,5,2,True,True
11881,248,26,4,0,10,2,6,2,True,True
11882,248,27,2,0,8,4,6,4,True,True
11883,248,28,2,0,9,3,7,3,True,True
11884,248,29,3,0,8,3,5,3,True,True
11885,248,30,2,1,9,7,7,6,True,True
11886,248,31,1,2,6,4,5,2,True,True
11887,248,32,1,0,5,4,4,4,True,True
11888,248,33,1,0,9,6,8,6,True,True
11889,248,34,1,0,4,8,3,8,True,True
11890,248,35,0,0,4,1,4,1,True,True
11891,248,36,0,0,5,4,5,4,True,True
11892,248,37,0,1,8,10,8,9,True,True
11893,248,38,0,1,11,11,11,10,True,True
11894,248,39,0,0,19,8,19,8,True,True
11895,248,40,1,0,17,3,16,3,True,True
11896,248,41,1,0,19,6,18,6,True,True
11897,248,42,0,0,22,13,22,13,True,True
11898,248,43,1,0,12,8,11,8,True,True
11899,248,44,1,1,25,5,24,4,True,True
11900,248,45,1,1,25,9,24,8,True,True
11901,248,46,0,0,31,15,31,15,True,True
11902,248,47,0,2,27,15,27,13,True,True
11903,248,48,1,2,28,18,27,16,True,True
11904,249,1,6156,4978,3942,3984,-2214,-994,False,False
11905,249,2,5126,5234,3254,4104,-1872,-1130,False,False
11906,249,3,4039,5546,2359,3604,-1680,-1942,False,False
11907,249,4,3099,5851,1801,3196,-1298,-2655,False,False
11908,249,5,2640,5440,1455,2806,-1185,-2634,False,False
11909,249,6,2156,4747,1077,2238,-1079,-2509,False,False
11910,249,7,1580,3863,881,1910,-699,-1953,False,False
11911,249,8,1409,3246,662,1498,-747,-1748,False,False
11912,249,9,1388,2419,511,1209,-877,-1210,False,False
11913,249,10,1126,1565,358,677,-768,-888,False,False
11914,249,11,1004,994,265,401,-739,-593,False,False
11915,249,12,1270,656,343,289,-927,-367,False,False
11916,249,13,1912,528,591,176,-1321,-352,False,False
11917,249,14,3421,541,827,210,-2594,-331,False,False
11918,249,15,4071,580,1052,225,-3019,-355,False,False
11919,249,16,3995,692,1561,335,-2434,-357,False,False
11920,249,17,3905,752,2365,395,-1540,-357,False,False
11921,249,18,4332,1029,2671,576,-1661,-453,False,False
11922,249,19,4846,1099,2382,777,-2464,-322,False,False
11923,249,20,4790,1515,2433,1077,-2357,-438,False,False
11924,249,21,4141,1521,2495,1302,-1646,-219,False,False
11925,249,22,3690,1825,2461,1632,-1229,-193,False,False
11926,249,23,3153,1951,2577,1986,-576,35,False,True
11927,249,24,3240,2058,2857,2230,-383,172,False,True
11928,249,25,3065,2202,3056,2457,-9,255,False,True
11929,249,26,3394,2323,3347,2447,-47,124,False,True
11930,249,27,3348,2441,3042,2550,-306,109,False,True
11931,249,28,3365,2477,2944,2430,-421,-47,False,False
11932,249,29,3311,2420,3022,2266,-289,-154,False,False
11933,249,30,3290,2486,3220,2163,-70,-323,False,False
11934,249,31,3312,2259,3236,2038,-76,-221,False,False
11935,249,32,2959,2340,2981,2006,22,-334,True,False
11936,249,33,2735,1965,2824,1897,89,-68,True,False
11937,249,34,2428,1759,2487,1737,59,-22,True,False
11938,249,35,2948,1905,2904,1873,-44,-32,False,False
11939,249,36,3587,2274,3999,2410,412,136,True,True
11940,249,37,4524,2393,5495,2829,971,436,True,True
11941,249,38,5276,2707,7019,3150,1743,443,True,True
11942,249,39,6171,2921,8317,3608,2146,687,True,True
11943,249,40,6526,3002,9223,3787,2697,785,True,True
11944,249,41,6903,3084,9296,4013,2393,929,True,True
11945,249,42,7137,3292,8974,3896,1837,604,True,True
11946,249,43,7871,3701,8122,3867,251,166,True,True
11947,249,44,7995,3718,7464,3379,-531,-339,False,False
11948,249,45,7821,4132,6812,3160,-1009,-972,False,False
11949,249,46,7740,4177,6362,3173,-1378,-1004,False,False
11950,249,47,7369,4317,5736,3142,-1633,-1175,False,False
11951,249,48,7397,3870,5479,3135,-1918,-735,False,False
11952,250,1,2,4,27,20,25,16,True,True
11953,250,2,2,2,25,17,23,15,True,True
11954,250,3,3,2,28,17,25,15,True,True
11955,250,4,0,0,18,18,18,18,True,True
11956,250,5,1,2,14,21,13,19,True,True
11957,250,6,2,0,13,20,11,20,True,True
11958,250,7,2,1,13,18,11,17,True,True
11959,250,8,0,3,6,17,6,14,True,True
11960,250,9,3,2,6,19,3,17,True,True
11961,250,10,2,2,10,29,8,27,True,True
11962,250,11,6,2,9,13,3,11,True,True
11963,250,12,4,2,10,5,6,3,True,True
11964,250,13,2,0,5,8,3,8,True,True
11965,250,14,5,2,6,6,1,4,True,True
11966,250,15,7,0,7,8,0,8,False,True
11967,250,16,5,2,10,1,5,-1,True,False
11968,250,17,5,1,11,9,6,8,True,True
11969,250,18,2,5,9,5,7,0,True,False
11970,250,19,3,1,13,5,10,4,True,True
11971,250,20,4,2,12,8,8,6,True,True
11972,250,21,2,5,13,7,11,2,True,True
11973,250,22,6,3,21,5,15,2,True,True
11974,250,23,1,3,10,6,9,3,True,True
11975,250,24,5,2,6,3,1,1,True,True
11976,250,25,3,0,8,3,5,3,True,True
11977,250,26,1,1,4,4,3,3,True,True
11978,250,27,2,1,8,5,6,4,True,True
11979,250,28,0,2,9,3,9,1,True,True
11980,250,29,1,1,7,5,6,4,True,True
11981,250,30,1,3,7,8,6,5,True,True
11982,250,31,2,0,10,8,8,8,True,True
11983,250,32,3,4,3,6,0,2,False,True
11984,250,33,2,4,3,9,1,5,True,True
11985,250,34,4,2,9,4,5,2,True,True
11986,250,35,2,2,7,4,5,2,True,True
11987,250,36,3,1,3,6,0,5,False,True
11988,250,37,4,1,14,8,10,7,True,True
11989,250,38,2,2,11,8,9,6,True,True
11990,250,39,2,2,9,7,7,5,True,True
11991,250,40,3,2,16,7,13,5,True,True
11992,250,41,4,1,15,12,11,11,True,True
11993,250,42,2,1,24,10,22,9,True,True
11994,250,43,4,1,26,9,22,8,True,True
11995,250,44,1,3,20,6,19,3,True,True
11996,250,45,2,0,18,8,16,8,True,True
11997,250,46,1,2,26,12,25,10,True,True
11998,250,47,1,0,26,10,25,10,True,True
11999,250,48,1,0,25,13,24,13,True,True
12000,251,1,0,0,6,0,6,0,True,False
12001,251,2,0,0,7,2,7,2,True,True
12002,251,3,0,0,4,6,4,6,True,True
12003,251,4,0,0,7,1,7,1,True,True
12004,251,5,0,0,5,5,5,5,True,True
12005,251,6,0,0,2,4,2,4,True,True
12006,251,7,0,0,3,1,3,1,True,True
12007,251,8,0,1,1,4,1,3,True,True
12008,251,9,0,0,1,1,1,1,True,True
12009,251,10,0,0,2,3,2,3,True,True
12010,251,11,0,0,1,1,1,1,True,True
12011,251,12,0,0,1,0,1,0,True,False
12012,251,13,0,0,0,0,0,0,False,False
12013,251,14,0,0,0,0,0,0,False,False
12014,251,15,0,0,0,0,0,0,False,False
12015,251,16,0,0,0,1,0,1,False,True
12016,251,17,0,0,2,1,2,1,True,True
12017,251,18,0,1,3,0,3,-1,True,False
12018,251,19,1,0,0,0,-1,0,False,False
12019,251,20,0,0,3,1,3,1,True,True
12020,251,21,0,0,0,0,0,0,False,False
12021,251,22,0,0,1,1,1,1,True,True
12022,251,23,0,0,3,0,3,0,True,False
12023,251,24,0,0,3,1,3,1,True,True
12024,251,25,0,0,1,1,1,1,True,True
12025,251,26,0,0,3,0,3,0,True,False
12026,251,27,0,0,1,1,1,1,True,True
12027,251,28,0,0,0,1,0,1,False,True
12028,251,29,0,0,1,0,1,0,True,False
12029,251,30,0,0,1,1,1,1,True,True
12030,251,31,0,0,0,1,0,1,False,True
12031,251,32,0,0,2,3,2,3,True,True
12032,251,33,0,0,0,2,0,2,False,True
12033,251,34,0,1,0,0,0,-1,False,False
12034,251,35,0,0,1,1,1,1,True,True
12035,251,36,0,0,0,1,0,1,False,True
12036,251,37,0,0,3,0,3,0,True,False
12037,251,38,0,0,0,4,0,4,False,True
12038,251,39,0,0,1,2,1,2,True,True
12039,251,40,0,0,1,1,1,1,True,True
12040,251,41,0,0,1,0,1,0,True,False
12041,251,42,1,0,6,1,5,1,True,True
12042,251,43,0,0,7,3,7,3,True,True
12043,251,44,0,0,8,1,8,1,True,True
12044,251,45,1,1,9,2,8,1,True,True
12045,251,46,0,0,9,3,9,3,True,True
12046,251,47,0,0,5,0,5,0,True,False
12047,251,48,0,1,5,0,5,-1,True,False
12048,252,1,3,1,37,15,34,14,True,True
12049,252,2,0,0,34,20,34,20,True,True
12050,252,3,0,2,26,28,26,26,True,True
12051,252,4,2,2,20,19,18,17,True,True
12052,252,5,0,0,25,16,25,16,True,True
12053,252,6,0,1,15,18,15,17,True,True
12054,252,7,0,0,12,13,12,13,True,True
12055,252,8,0,2,7,24,7,22,True,True
12056,252,9,0,0,2,17,2,17,True,True
12057,252,10,1,1,3,10,2,9,True,True
12058,252,11,0,0,4,11,4,11,True,True
12059,252,12,2,0,6,3,4,3,True,True
12060,252,13,3,0,9,3,6,3,True,True
12061,252,14,1,0,8,11,7,11,True,True
12062,252,15,2,0,8,7,6,7,True,True
12063,252,16,1,0,17,3,16,3,True,True
12064,252,17,4,0,13,4,9,4,True,True
12065,252,18,3,0,25,3,22,3,True,True
12066,252,19,3,0,19,6,16,6,True,True
12067,252,20,3,0,15,9,12,9,True,True
12068,252,21,0,1,8,8,8,7,True,True
12069,252,22,1,1,11,5,10,4,True,True
12070,252,23,1,0,16,6,15,6,True,True
12071,252,24,2,0,19,10,17,10,True,True
12072,252,25,1,0,16,8,15,8,True,True
12073,252,26,0,0,17,15,17,15,True,True
12074,252,27,0,1,16,7,16,6,True,True
12075,252,28,0,0,21,17,21,17,True,True
12076,252,29,0,0,20,13,20,13,True,True
12077,252,30,1,0,20,11,19,11,True,True
12078,252,31,2,2,21,12,19,10,True,True
12079,252,32,1,0,17,11,16,11,True,True
12080,252,33,0,1,26,14,26,13,True,True
12081,252,34,1,0,19,9,18,9,True,True
12082,252,35,1,1,20,10,19,9,True,True
12083,252,36,0,1,13,12,13,11,True,True
12084,252,37,0,1,20,4,20,3,True,True
12085,252,38,2,0,17,13,15,13,True,True
12086,252,39,1,0,27,12,26,12,True,True
12087,252,40,2,0,33,10,31,10,True,True
12088,252,41,1,2,24,14,23,12,True,True
12089,252,42,1,0,20,9,19,9,True,True
12090,252,43,0,1,31,19,31,18,True,True
12091,252,44,2,2,50,15,48,13,True,True
12092,252,45,2,2,50,13,48,11,True,True
12093,252,46,1,0,45,15,44,15,True,True
12094,252,47,1,1,44,15,43,14,True,True
12095,252,48,0,0,47,16,47,16,True,True
12096,253,1,0,0,0,2,0,2,False,True
12097,253,2,0,0,0,1,0,1,False,True
12098,253,3,0,0,2,0,2,0,True,False
12099,253,4,1,0,1,0,0,0,False,False
12100,253,5,0,0,3,0,3,0,True,False
12101,253,6,0,0,0,1,0,1,False,True
12102,253,7,0,0,1,0,1,0,True,False
12103,253,8,0,0,1,1,1,1,True,True
12104,253,9,1,0,2,0,1,0,True,False
12105,253,10,0,0,0,2,0,2,False,True
12106,253,11,0,0,1,0,1,0,True,False
12107,253,12,0,1,0,0,0,-1,False,False
12108,253,13,2,0,1,1,-1,1,False,True
12109,253,14,0,0,0,0,0,0,False,False
12110,253,15,1,0,0,0,-1,0,False,False
12111,253,16,0,0,0,1,0,1,False,True
12112,253,17,1,1,0,1,-1,0,False,False
12113,253,18,0,0,2,2,2,2,True,True
12114,253,19,1,0,2,0,1,0,True,False
12115,253,20,0,0,3,1,3,1,True,True
12116,253,21,0,1,5,0,5,-1,True,False
12117,253,22,1,0,2,1,1,1,True,True
12118,253,23,1,0,1,4,0,4,False,True
12119,253,24,1,1,3,0,2,-1,True,False
12120,253,25,0,0,1,1,1,1,True,True
12121,253,26,0,1,4,4,4,3,True,True
12122,253,27,2,1,4,1,2,0,True,False
12123,253,28,0,0,3,2,3,2,True,True
12124,253,29,1,0,3,0,2,0,True,False
12125,253,30,0,1,0,3,0,2,False,True
12126,253,31,1,1,3,2,2,1,True,True
12127,253,32,2,1,2,1,0,0,False,False
12128,253,33,0,2,0,1,0,-1,False,False
12129,253,34,1,1,0,1,-1,0,False,False
12130,253,35,0,0,0,1,0,1,False,True
12131,253,36,1,0,0,0,-1,0,False,False
12132,253,37,0,0,2,0,2,0,True,False
12133,253,38,2,1,5,0,3,-1,True,False
12134,253,39,3,0,3,1,0,1,False,True
12135,253,40,1,0,2,1,1,1,True,True
12136,253,41,1,0,4,0,3,0,True,False
12137,253,42,0,0,1,1,1,1,True,True
12138,253,43,1,0,0,3,-1,3,False,True
12139,253,44,0,0,0,1,0,1,False,True
12140,253,45,2,0,2,2,0,2,False,True
12141,253,46,1,0,0,0,-1,0,False,False
12142,253,47,0,0,1,0,1,0,True,False
12143,253,48,0,0,3,1,3,1,True,True
12144,254,1,2,2,27,10,25,8,True,True
12145,254,2,0,0,21,13,21,13,True,True
12146,254,3,2,0,27,12,25,12,True,True
12147,254,4,1,2,16,21,15,19,True,True
12148,254,5,0,0,16,16,16,16,True,True
12149,254,6,0,0,22,16,22,16,True,True
12150,254,7,0,0,15,14,15,14,True,True
12151,254,8,1,2,12,16,11,14,True,True
12152,254,9,1,2,16,23,15,21,True,True
12153,254,10,0,1,6,21,6,20,True,True
12154,254,11,0,0,4,14,4,14,True,True
12155,254,12,1,0,7,7,6,7,True,True
12156,254,13,0,0,7,1,7,1,True,True
12157,254,14,0,0,2,4,2,4,True,True
12158,254,15,1,0,5,5,4,5,True,True
12159,254,16,0,0,8,4,8,4,True,True
12160,254,17,0,0,10,4,10,4,True,True
12161,254,18,0,0,8,2,8,2,True,True
12162,254,19,0,1,8,2,8,1,True,True
12163,254,20,0,2,7,3,7,1,True,True
12164,254,21,1,0,8,3,7,3,True,True
12165,254,22,0,1,6,4,6,3,True,True
12166,254,23,0,0,8,2,8,2,True,True
12167,254,24,0,0,8,5,8,5,True,True
12168,254,25,1,0,12,4,11,4,True,True
12169,254,26,0,0,6,4,6,4,True,True
12170,254,27,0,0,9,3,9,3,True,True
12171,254,28,0,0,10,2,10,2,True,True
12172,254,29,0,0,4,9,4,9,True,True
12173,254,30,0,0,6,6,6,6,True,True
12174,254,31,0,0,6,2,6,2,True,True
12175,254,32,0,1,5,3,5,2,True,True
12176,254,33,1,0,5,3,4,3,True,True
12177,254,34,0,1,4,4,4,3,True,True
12178,254,35,2,0,11,5,9,5,True,True
12179,254,36,0,0,13,6,13,6,True,True
12180,254,37,1,0,7,8,6,8,True,True
12181,254,38,1,0,16,8,15,8,True,True
12182,254,39,0,0,5,4,5,4,True,True
12183,254,40,1,0,13,7,12,7,True,True
12184,254,41,0,0,12,4,12,4,True,True
12185,254,42,3,0,20,8,17,8,True,True
12186,254,43,0,0,25,8,25,8,True,True
12187,254,44,1,1,31,10,30,9,True,True
12188,254,45,1,0,21,12,20,12,True,True
12189,254,46,0,0,22,9,22,9,True,True
12190,254,47,0,1,26,11,26,10,True,True
12191,254,48,1,1,32,12,31,11,True,True
12192,255,1,2622,2070,1567,1349,-1055,-721,False,False
12193,255,2,2395,2301,1573,1494,-822,-807,False,False
12194,255,3,2057,2451,1260,1454,-797,-997,False,False
12195,255,4,1582,2810,893,1365,-689,-1445,False,False
12196,255,5,1389,2720,710,1143,-679,-1577,False,False
12197,255,6,1020,2559,591,1071,-429,-1488,False,False
12198,255,7,744,2130,430,859,-314,-1271,False,False
12199,255,8,634,1770,336,711,-298,-1059,False,False
12200,255,9,537,1457,277,620,-260,-837,False,False
12201,255,10,272,926,217,477,-55,-449,False,False
12202,255,11,139,444,126,238,-13,-206,False,False
12203,255,12,79,260,92,150,13,-110,True,False
12204,255,13,57,149,102,100,45,-49,True,False
12205,255,14,78,99,116,93,38,-6,True,False
12206,255,15,43,82,80,76,37,-6,True,False
12207,255,16,65,82,118,58,53,-24,True,False
12208,255,17,61,103,130,77,69,-26,True,False
12209,255,18,103,96,163,124,60,28,True,True
12210,255,19,97,85,204,157,107,72,True,True
12211,255,20,105,115,241,209,136,94,True,True
12212,255,21,104,113,246,227,142,114,True,True
12213,255,22,85,148,261,289,176,141,True,True
12214,255,23,92,159,228,312,136,153,True,True
12215,255,24,90,192,242,367,152,175,True,True
12216,255,25,105,199,273,392,168,193,True,True
12217,255,26,134,229,297,432,163,203,True,True
12218,255,27,95,260,295,494,200,234,True,True
12219,255,28,119,387,308,507,189,120,True,True
12220,255,29,121,398,312,544,191,146,True,True
12221,255,30,124,347,370,501,246,154,True,True
12222,255,31,151,357,344,515,193,158,True,True
12223,255,32,130,364,347,439,217,75,True,True
12224,255,33,142,313,327,453,185,140,True,True
12225,255,34,141,297,291,405,150,108,True,True
12226,255,35,199,387,345,415,146,28,True,True
12227,255,36,333,419,496,530,163,111,True,True
12228,255,37,441,511,716,609,275,98,True,True
12229,255,38,583,504,855,585,272,81,True,True
12230,255,39,708,568,1087,675,379,107,True,True
12231,255,40,817,600,1298,730,481,130,True,True
12232,255,41,917,631,1507,714,590,83,True,True
12233,255,42,1146,639,1652,700,506,61,True,True
12234,255,43,1372,734,1833,740,461,6,True,True
12235,255,44,1613,876,1978,776,365,-100,True,False
12236,255,45,1841,944,1960,796,119,-148,True,False
12237,255,46,2136,1080,1927,885,-209,-195,False,False
12238,255,47,2496,1217,2074,904,-422,-313,False,False
12239,255,48,2908,1441,2205,1066,-703,-375,False,False
12240,256,1,1398,1351,1936,1215,538,-136,True,False
12241,256,2,1215,1523,1837,1428,622,-95,True,False
12242,256,3,1045,1686,1514,1529,469,-157,True,False
12243,256,4,867,1724,1242,1467,375,-257,True,False
12244,256,5,793,1576,1045,1416,252,-160,True,False
12245,256,6,591,1522,826,1221,235,-301,True,False
12246,256,7,438,1341,626,1103,188,-238,True,False
12247,256,8,381,1132,530,912,149,-220,True,False
12248,256,9,329,936,490,895,161,-41,True,False
12249,256,10,182,518,308,666,126,148,True,True
12250,256,11,141,264,190,383,49,119,True,True
12251,256,12,80,211,134,239,54,28,True,True
12252,256,13,75,126,113,116,38,-10,True,False
12253,256,14,103,90,117,85,14,-5,True,False
12254,256,15,86,80,61,86,-25,6,False,True
12255,256,16,115,55,133,74,18,19,True,True
12256,256,17,136,90,136,55,0,-35,False,False
12257,256,18,128,77,129,61,1,-16,True,False
12258,256,19,124,68,124,101,0,33,False,True
12259,256,20,113,97,181,107,68,10,True,True
12260,256,21,118,108,140,131,22,23,True,True
12261,256,22,119,126,159,155,40,29,True,True
12262,256,23,88,128,214,194,126,66,True,True
12263,256,24,110,155,244,212,134,57,True,True
12264,256,25,113,146,252,244,139,98,True,True
12265,256,26,134,168,314,292,180,124,True,True
12266,256,27,126,187,266,281,140,94,True,True
12267,256,28,129,194,270,281,141,87,True,True
12268,256,29,133,230,307,311,174,81,True,True
12269,256,30,140,200,339,327,199,127,True,True
12270,256,31,148,176,308,287,160,111,True,True
12271,256,32,132,186,326,311,194,125,True,True
12272,256,33,123,161,285,321,162,160,True,True
12273,256,34,146,178,248,304,102,126,True,True
12274,256,35,174,199,333,323,159,124,True,True
12275,256,36,185,236,469,389,284,153,True,True
12276,256,37,281,273,653,451,372,178,True,True
12277,256,38,365,290,841,509,476,219,True,True
12278,256,39,343,325,972,569,629,244,True,True
12279,256,40,520,369,1218,651,698,282,True,True
12280,256,41,613,378,1403,602,790,224,True,True
12281,256,42,632,429,1482,653,850,224,True,True
12282,256,43,846,471,1674,685,828,214,True,True
12283,256,44,888,512,1732,708,844,196,True,True
12284,256,45,1124,593,1879,749,755,156,True,True
12285,256,46,1221,639,1914,832,693,193,True,True
12286,256,47,1454,776,2032,858,578,82,True,True
12287,256,48,1547,947,2194,960,647,13,True,True
12288,257,1,32,32,347,168,315,136,True,True
12289,257,2,13,17,305,218,292,201,True,True
12290,257,3,16,22,261,183,245,161,True,True
12291,257,4,12,13,191,195,179,182,True,True
12292,257,5,8,15,140,163,132,148,True,True
12293,257,6,2,10,109,167,107,157,True,True
12294,257,7,7,13,77,172,70,159,True,True
12295,257,8,6,9,67,132,61,123,True,True
12296,257,9,6,6,56,107,50,101,True,True
12297,257,10,5,7,44,66,39,59,True,True
12298,257,11,2,1,19,52,17,51,True,True
12299,257,12,3,1,20,21,17,20,True,True
12300,257,13,3,2,20,20,17,18,True,True
12301,257,14,9,3,15,16,6,13,True,True
12302,257,15,13,7,9,15,-4,8,False,True
12303,257,16,14,2,11,24,-3,22,False,True
12304,257,17,12,1,14,19,2,18,True,True
12305,257,18,10,3,19,14,9,11,True,True
12306,257,19,18,4,26,21,8,17,True,True
12307,257,20,6,4,23,27,17,23,True,True
12308,257,21,4,3,29,21,25,18,True,True
12309,257,22,3,1,19,21,16,20,True,True
12310,257,23,3,4,16,23,13,19,True,True
12311,257,24,1,3,22,19,21,16,True,True
12312,257,25,0,1,24,20,24,19,True,True
12313,257,26,3,4,26,30,23,26,True,True
12314,257,27,2,4,22,24,20,20,True,True
12315,257,28,7,3,32,27,25,24,True,True
12316,257,29,5,5,37,20,32,15,True,True
12317,257,30,2,6,40,28,38,22,True,True
12318,257,31,3,6,40,38,37,32,True,True
12319,257,32,5,3,32,35,27,32,True,True
12320,257,33,1,3,36,33,35,30,True,True
12321,257,34,10,0,40,27,30,27,True,True
12322,257,35,1,8,30,41,29,33,True,True
12323,257,36,6,9,50,31,44,22,True,True
12324,257,37,8,4,54,42,46,38,True,True
12325,257,38,7,7,84,54,77,47,True,True
12326,257,39,6,2,116,40,110,38,True,True
12327,257,40,9,6,144,59,135,53,True,True
12328,257,41,8,3,150,54,142,51,True,True
12329,257,42,11,11,176,58,165,47,True,True
12330,257,43,7,8,223,60,216,52,True,True
12331,257,44,15,14,302,85,287,71,True,True
12332,257,45,16,4,284,78,268,74,True,True
12333,257,46,30,13,303,86,273,73,True,True
12334,257,47,25,20,312,113,287,93,True,True
12335,257,48,23,23,322,136,299,113,True,True
12336,258,1,3,0,65,27,62,27,True,True
12337,258,2,3,3,63,51,60,48,True,True
12338,258,3,6,3,71,43,65,40,True,True
12339,258,4,2,2,47,46,45,44,True,True
12340,258,5,1,7,39,59,38,52,True,True
12341,258,6,1,4,38,57,37,53,True,True
12342,258,7,3,2,31,40,28,38,True,True
12343,258,8,3,5,25,28,22,23,True,True
12344,258,9,3,3,22,47,19,44,True,True
12345,258,10,5,2,28,43,23,41,True,True
12346,258,11,7,7,16,37,9,30,True,True
12347,258,12,9,1,12,35,3,34,True,True
12348,258,13,13,2,18,15,5,13,True,True
12349,258,14,8,8,15,14,7,6,True,True
12350,258,15,4,2,17,10,13,8,True,True
12351,258,16,4,5,14,6,10,1,True,True
12352,258,17,4,3,7,9,3,6,True,True
12353,258,18,1,5,13,6,12,1,True,True
12354,258,19,3,4,15,2,12,-2,True,False
12355,258,20,1,7,12,11,11,4,True,True
12356,258,21,1,5,18,9,17,4,True,True
12357,258,22,3,1,29,6,26,5,True,True
12358,258,23,1,3,9,3,8,0,True,False
12359,258,24,4,1,13,9,9,8,True,True
12360,258,25,1,1,19,6,18,5,True,True
12361,258,26,4,2,20,5,16,3,True,True
12362,258,27,2,1,15,5,13,4,True,True
12363,258,28,1,2,14,6,13,4,True,True
12364,258,29,1,1,17,11,16,10,True,True
12365,258,30,2,0,21,10,19,10,True,True
12366,258,31,0,2,21,13,21,11,True,True
12367,258,32,5,1,14,8,9,7,True,True
12368,258,33,2,3,28,9,26,6,True,True
12369,258,34,3,1,19,9,16,8,True,True
12370,258,35,3,0,20,12,17,12,True,True
12371,258,36,5,1,21,7,16,6,True,True
12372,258,37,7,2,21,19,14,17,True,True
12373,258,38,4,0,23,8,19,8,True,True
12374,258,39,6,1,30,6,24,5,True,True
12375,258,40,9,0,31,9,22,9,True,True
12376,258,41,5,0,32,12,27,12,True,True
12377,258,42,5,2,41,12,36,10,True,True
12378,258,43,5,3,68,19,63,16,True,True
12379,258,44,5,3,73,13,68,10,True,True
12380,258,45,3,1,64,27,61,26,True,True
12381,258,46,3,2,51,17,48,15,True,True
12382,258,47,3,1,96,21,93,20,True,True
12383,258,48,4,2,85,39,81,37,True,True
12384,259,1,1,1,47,27,46,26,True,True
12385,259,2,0,2,47,34,47,32,True,True
12386,259,3,0,0,28,25,28,25,True,True
12387,259,4,4,2,36,47,32,45,True,True
12388,259,5,2,2,28,37,26,35,True,True
12389,259,6,0,1,36,49,36,48,True,True
12390,259,7,1,2,27,50,26,48,True,True
12391,259,8,0,3,26,34,26,31,True,True
12392,259,9,0,3,23,35,23,32,True,True
12393,259,10,1,2,26,38,25,36,True,True
12394,259,11,1,1,31,37,30,36,True,True
12395,259,12,1,2,12,19,11,17,True,True
12396,259,13,1,3,8,19,7,16,True,True
12397,259,14,1,0,3,6,2,6,True,True
12398,259,15,0,1,4,6,4,5,True,True
12399,259,16,1,0,9,7,8,7,True,True
12400,259,17,1,0,7,5,6,5,True,True
12401,259,18,0,0,1,11,1,11,True,True
12402,259,19,2,0,6,3,4,3,True,True
12403,259,20,0,1,5,9,5,8,True,True
12404,259,21,0,0,3,6,3,6,True,True
12405,259,22,0,1,4,0,4,-1,True,False
12406,259,23,1,0,3,7,2,7,True,True
12407,259,24,0,0,5,8,5,8,True,True
12408,259,25,1,0,3,3,2,3,True,True
12409,259,26,0,0,3,3,3,3,True,True
12410,259,27,0,0,4,5,4,5,True,True
12411,259,28,0,0,6,8,6,8,True,True
12412,259,29,0,0,7,7,7,7,True,True
12413,259,30,0,0,13,4,13,4,True,True
12414,259,31,0,1,11,5,11,4,True,True
12415,259,32,0,0,11,5,11,5,True,True
12416,259,33,0,0,5,1,5,1,True,True
12417,259,34,0,0,9,4,9,4,True,True
12418,259,35,0,0,6,6,6,6,True,True
12419,259,36,0,0,4,7,4,7,True,True
12420,259,37,1,0,11,12,10,12,True,True
12421,259,38,1,0,9,8,8,8,True,True
12422,259,39,0,1,19,9,19,8,True,True
12423,259,40,0,1,28,6,28,5,True,True
12424,259,41,0,0,19,9,19,9,True,True
12425,259,42,0,0,19,11,19,11,True,True
12426,259,43,0,2,27,12,27,10,True,True
12427,259,44,0,1,39,17,39,16,True,True
12428,259,45,3,0,40,13,37,13,True,True
12429,259,46,2,0,49,17,47,17,True,True
12430,259,47,3,0,59,20,56,20,True,True
12431,259,48,3,0,38,19,35,19,True,True
12432,260,1,106,79,582,280,476,201,True,True
12433,260,2,109,95,601,392,492,297,True,True
12434,260,3,115,111,585,444,470,333,True,True
12435,260,4,112,119,512,454,400,335,True,True
12436,260,5,90,104,388,420,298,316,True,True
12437,260,6,94,100,331,408,237,308,True,True
12438,260,7,100,116,281,391,181,275,True,True
12439,260,8,98,101,244,325,146,224,True,True
12440,260,9,117,147,240,362,123,215,True,True
12441,260,10,127,98,221,342,94,244,True,True
12442,260,11,157,105,158,251,1,146,True,True
12443,260,12,238,90,127,184,-111,94,False,True
12444,260,13,197,92,105,124,-92,32,False,True
12445,260,14,316,116,107,93,-209,-23,False,False
12446,260,15,324,117,110,96,-214,-21,False,False
12447,260,16,361,109,141,85,-220,-24,False,False
12448,260,17,266,106,115,83,-151,-23,False,False
12449,260,18,241,120,124,92,-117,-28,False,False
12450,260,19,197,124,152,111,-45,-13,False,False
12451,260,20,121,149,93,103,-28,-46,False,False
12452,260,21,97,132,92,114,-5,-18,False,False
12453,260,22,88,118,95,119,7,1,True,True
12454,260,23,83,83,114,98,31,15,True,True
12455,260,24,92,89,110,98,18,9,True,True
12456,260,25,69,82,93,98,24,16,True,True
12457,260,26,70,64,95,77,25,13,True,True
12458,260,27,71,59,105,71,34,12,True,True
12459,260,28,67,55,104,66,37,11,True,True
12460,260,29,69,42,102,67,33,25,True,True
12461,260,30,73,58,124,70,51,12,True,True
12462,260,31,88,40,118,70,30,30,True,True
12463,260,32,81,45,124,70,43,25,True,True
12464,260,33,75,34,119,96,44,62,True,True
12465,260,34,67,60,116,76,49,16,True,True
12466,260,35,91,55,119,70,28,15,True,True
12467,260,36,102,56,155,94,53,38,True,True
12468,260,37,72,46,138,83,66,37,True,True
12469,260,38,75,52,164,75,89,23,True,True
12470,260,39,58,52,168,76,110,24,True,True
12471,260,40,53,52,188,101,135,49,True,True
12472,260,41,43,41,161,100,118,59,True,True
12473,260,42,55,43,214,105,159,62,True,True
12474,260,43,69,39,274,114,205,75,True,True
12475,260,44,70,45,321,132,251,87,True,True
12476,260,45,58,70,362,137,304,67,True,True
12477,260,46,87,50,434,169,347,119,True,True
12478,260,47,86,71,481,225,395,154,True,True
12479,260,48,90,83,545,295,455,212,True,True
12480,261,1,603,570,1043,678,440,108,True,True
12481,261,2,477,490,941,702,464,212,True,True
12482,261,3,328,387,704,736,376,349,True,True
12483,261,4,277,333,515,762,238,429,True,True
12484,261,5,198,261,411,752,213,491,True,True
12485,261,6,135,157,305,642,170,485,True,True
12486,261,7,100,134,240,597,140,463,True,True
12487,261,8,83,97,182,531,99,434,True,True
12488,261,9,93,106,169,438,76,332,True,True
12489,261,10,120,100,162,276,42,176,True,True
12490,261,11,161,84,120,175,-41,91,False,True
12491,261,12,230,88,210,103,-20,15,False,True
12492,261,13,340,99,374,92,34,-7,True,False
12493,261,14,519,129,643,87,124,-42,True,False
12494,261,15,687,155,857,90,170,-65,True,False
12495,261,16,807,232,1110,139,303,-93,True,False
12496,261,17,897,219,1235,172,338,-47,True,False
12497,261,18,956,308,1377,245,421,-63,True,False
12498,261,19,1038,382,1475,423,437,41,True,True
12499,261,20,1037,469,1695,600,658,131,True,True
12500,261,21,1044,477,1687,756,643,279,True,True
12501,261,22,1170,691,1450,778,280,87,True,True
12502,261,23,1139,821,1359,773,220,-48,True,False
12503,261,24,1314,900,1215,683,-99,-217,False,False
12504,261,25,1337,860,1181,705,-156,-155,False,False
12505,261,26,1404,973,1218,784,-186,-189,False,False
12506,261,27,1485,1077,1292,836,-193,-241,False,False
12507,261,28,1547,1029,1335,806,-212,-223,False,False
12508,261,29,1562,1007,1257,741,-305,-266,False,False
12509,261,30,1391,980,1260,745,-131,-235,False,False
12510,261,31,1310,972,1135,692,-175,-280,False,False
12511,261,32,1043,780,865,629,-178,-151,False,False
12512,261,33,853,744,744,620,-109,-124,False,False
12513,261,34,851,615,646,488,-205,-127,False,False
12514,261,35,1126,783,625,486,-501,-297,False,False
12515,261,36,1206,919,736,527,-470,-392,False,False
12516,261,37,1229,842,752,561,-477,-281,False,False
12517,261,38,1162,849,734,514,-428,-335,False,False
12518,261,39,1178,791,791,493,-387,-298,False,False
12519,261,40,1247,724,919,502,-328,-222,False,False
12520,261,41,1298,658,929,494,-369,-164,False,False
12521,261,42,1314,543,1010,461,-304,-82,False,False
12522,261,43,1469,553,1242,543,-227,-10,False,False
12523,261,44,1278,449,1339,611,61,162,True,True
12524,261,45,1141,461,1370,597,229,136,True,True
12525,261,46,978,419,1285,650,307,231,True,True
12526,261,47,899,473,1332,595,433,122,True,True
12527,261,48,723,395,1202,540,479,145,True,True
12528,262,1,716,793,2324,1518,1608,725,True,True
12529,262,2,497,707,1833,1537,1336,830,True,True
12530,262,3,395,549,1263,1355,868,806,True,True
12531,262,4,234,504,881,1339,647,835,True,True
12532,262,5,170,439,704,1183,534,744,True,True
12533,262,6,136,350,486,1046,350,696,True,True
12534,262,7,113,225,379,931,266,706,True,True
12535,262,8,140,209,302,830,162,621,True,True
12536,262,9,167,186,228,652,61,466,True,True
12537,262,10,394,202,226,462,-168,260,False,True
12538,262,11,597,215,310,263,-287,48,False,True
12539,262,12,1143,220,359,197,-784,-23,False,False
12540,262,13,1975,304,429,183,-1546,-121,False,False
12541,262,14,3865,474,624,229,-3241,-245,False,False
12542,262,15,5394,600,912,212,-4482,-388,False,False
12543,262,16,5680,832,1516,390,-4164,-442,False,False
12544,262,17,4893,888,1801,414,-3092,-474,False,False
12545,262,18,3173,1182,1639,471,-1534,-711,False,False
12546,262,19,3133,1482,1341,634,-1792,-848,False,False
12547,262,20,3691,1710,1369,758,-2322,-952,False,False
12548,262,21,3946,1776,1508,896,-2438,-880,False,False
12549,262,22,3824,1913,1659,953,-2165,-960,False,False
12550,262,23,3415,1797,1843,987,-1572,-810,False,False
12551,262,24,3430,1809,2108,991,-1322,-818,False,False
12552,262,25,3208,1656,2127,1077,-1081,-579,False,False
12553,262,26,3131,1631,1960,1004,-1171,-627,False,False
12554,262,27,2880,1545,2150,999,-730,-546,False,False
12555,262,28,2817,1493,2365,1074,-452,-419,False,False
12556,262,29,2785,1398,2584,1142,-201,-256,False,False
12557,262,30,3053,1320,3111,1238,58,-82,True,False
12558,262,31,3449,1318,3388,1285,-61,-33,False,False
12559,262,32,2946,1305,3454,1270,508,-35,True,False
12560,262,33,2425,1188,3050,1322,625,134,True,True
12561,262,34,2314,1051,2865,1159,551,108,True,True
12562,262,35,2791,1227,3188,1209,397,-18,True,False
12563,262,36,3406,1357,4021,1314,615,-43,True,False
12564,262,37,3728,1413,4424,1450,696,37,True,True
12565,262,38,3862,1440,4700,1325,838,-115,True,False
12566,262,39,3789,1446,4733,1321,944,-125,True,False
12567,262,40,3229,1174,4587,1167,1358,-7,True,False
12568,262,41,2506,1071,4393,1215,1887,144,True,True
12569,262,42,2141,960,4337,1299,2196,339,True,True
12570,262,43,2086,889,4740,1321,2654,432,True,True
12571,262,44,1813,826,5067,1364,3254,538,True,True
12572,262,45,1909,869,4943,1447,3034,578,True,True
12573,262,46,1467,791,4236,1511,2769,720,True,True
12574,262,47,1293,782,3810,1450,2517,668,True,True
12575,262,48,1063,679,3078,1298,2015,619,True,True
12576,263,1,2261,2274,4022,2815,1761,541,True,True
12577,263,2,1770,2159,3130,2991,1360,832,True,True
12578,263,3,1238,1790,2254,2824,1016,1034,True,True
12579,263,4,941,1532,1539,2695,598,1163,True,True
12580,263,5,764,1258,1210,2653,446,1395,True,True
12581,263,6,588,1133,958,2322,370,1189,True,True
12582,263,7,461,872,733,1990,272,1118,True,True
12583,263,8,414,843,542,1635,128,792,True,True
12584,263,9,526,738,520,1383,-6,645,False,True
12585,263,10,665,495,384,889,-281,394,False,True
12586,263,11,893,404,356,527,-537,123,False,True
12587,263,12,1494,400,564,350,-930,-50,False,False
12588,263,13,2659,463,635,258,-2024,-205,False,False
12589,263,14,4508,667,1033,283,-3475,-384,False,False
12590,263,15,5995,842,1222,348,-4773,-494,False,False
12591,263,16,5803,1093,1434,490,-4369,-603,False,False
12592,263,17,5118,1202,1752,567,-3366,-635,False,False
12593,263,18,3625,1474,1770,753,-1855,-721,False,False
12594,263,19,3903,1647,1841,969,-2062,-678,False,False
12595,263,20,4055,2079,1829,1195,-2226,-884,False,False
12596,263,21,3978,2213,2247,1415,-1731,-798,False,False
12597,263,22,4055,2353,2436,1556,-1619,-797,False,False
12598,263,23,3684,2387,2605,1575,-1079,-812,False,False
12599,263,24,3828,2580,2645,1646,-1183,-934,False,False
12600,263,25,3582,2325,2916,1653,-666,-672,False,False
12601,263,26,3449,2435,2793,1671,-656,-764,False,False
12602,263,27,3206,2282,2848,1658,-358,-624,False,False
12603,263,28,3440,2284,2983,1683,-457,-601,False,False
12604,263,29,3648,2250,3304,1778,-344,-472,False,False
12605,263,30,3577,2044,3443,1798,-134,-246,False,False
12606,263,31,3419,1956,3711,1843,292,-113,True,False
12607,263,32,3413,2044,3668,1914,255,-130,True,False
12608,263,33,2867,1958,3376,1917,509,-41,True,False
12609,263,34,2844,1776,3173,1864,329,88,True,True
12610,263,35,3500,1843,3700,1899,200,56,True,True
12611,263,36,4073,2092,4676,2052,603,-40,True,False
12612,263,37,4549,2173,5639,2337,1090,164,True,True
12613,263,38,4967,2201,6362,2406,1395,205,True,True
12614,263,39,4985,2342,6683,2432,1698,90,True,True
12615,263,40,4654,2258,6827,2357,2173,99,True,True
12616,263,41,4405,2129,6831,2321,2426,192,True,True
12617,263,42,4306,2030,6736,2242,2430,212,True,True
12618,263,43,4644,2063,7023,2348,2379,285,True,True
12619,263,44,4569,2086,7152,2371,2583,285,True,True
12620,263,45,4554,1986,7225,2532,2671,546,True,True
12621,263,46,3902,1919,6695,2495,2793,576,True,True
12622,263,47,3528,2046,6361,2579,2833,533,True,True
12623,263,48,3201,1801,5397,2319,2196,518,True,True
